lad22cd,lad22nm,category,count_21,count_11,change
E09000001,City of London,Africa: Africa not otherwise specified,0,0,0
E09000001,City of London,Africa: Central and Western Africa: Ghana,24,20,4
E09000001,City of London,Africa: Central and Western Africa: Nigeria,21,12,9
E09000001,City of London,Africa: Central and Western Africa: Other Central and Western Africa,17,27,-10
E09000001,City of London,Africa: North Africa,83,49,34
E09000001,City of London,Africa: South and Eastern Africa: Kenya,28,19,9
E09000001,City of London,Africa: South and Eastern Africa: Other South and Eastern Africa,43,48,-5
E09000001,City of London,Africa: South and Eastern Africa: Somalia,16,2,14
E09000001,City of London,Africa: South and Eastern Africa: South Africa,68,73,-5
E09000001,City of London,Africa: South and Eastern Africa: Zimbabwe,12,13,-1
E09000001,City of London,Antarctica and Oceania: Australasia: Australia,155,137,18
E09000001,City of London,Antarctica and Oceania: Australasia: Other Australasia,50,80,-30
E09000001,City of London,Antarctica and Oceania: Other Oceania and Antarctica,0,2,-2
E09000001,City of London,Europe: Other Europe: EU countries: Countries that joined the EU between April 2001 and March 2011: Lithuania,24,15,9
E09000001,City of London,Europe: Other Europe: EU countries: Countries that joined the EU between April 2001 and March 2011: Other EU countries,177,67,110
E09000001,City of London,Europe: Other Europe: EU countries: Countries that joined the EU between April 2001 and March 2011: Poland,131,46,85
E09000001,City of London,Europe: Other Europe: EU countries: Countries that joined the EU between April 2001 and March 2011: Romania,50,15,35
E09000001,City of London,Europe: Other Europe: EU countries: Member countries in March 2001: France,207,147,60
E09000001,City of London,Europe: Other Europe: EU countries: Member countries in March 2001: Germany,153,121,32
E09000001,City of London,Europe: Other Europe: EU countries: Member countries in March 2001: Ireland,100,111,-11
E09000001,City of London,Europe: Other Europe: EU countries: Member countries in March 2001: Italy,250,100,150
E09000001,City of London,Europe: Other Europe: EU countries: Member countries in March 2001: Other member countries in March 2001,293,194,99
E09000001,City of London,Europe: Other Europe: EU countries: Member countries in March 2001: Portugal (including Madeira and the Azores),53,17,36
E09000001,City of London,Europe: Other Europe: EU countries: Member countries in March 2001: Spain (including Canary Islands),129,73,56
E09000001,City of London,Europe: Other Europe: Rest of Europe: Other Europe,309,162,147
E09000001,City of London,Europe: Other Europe: Rest of Europe: Turkey,47,19,28
E09000001,City of London,Europe: United Kingdom: England,4044,4285,-241
E09000001,City of London,Europe: United Kingdom: Great Britain not otherwise specified,0,0,0
E09000001,City of London,Europe: United Kingdom: Northern Ireland,38,68,-30
E09000001,City of London,Europe: United Kingdom: Scotland,159,204,-45
E09000001,City of London,Europe: United Kingdom: United Kingdom not otherwise specified,0,2,-2
E09000001,City of London,Europe: United Kingdom: Wales,86,111,-25
E09000001,City of London,Middle East and Asia: Central Asia,14,12,2
E09000001,City of London,Middle East and Asia: Eastern Asia: China,282,96,186
E09000001,City of London,Middle East and Asia: Eastern Asia: Hong Kong (Special Administrative Region of China),105,75,30
E09000001,City of London,Middle East and Asia: Eastern Asia: Other Eastern Asia,117,80,37
E09000001,City of London,Middle East and Asia: Middle East: Iran,41,14,27
E09000001,City of London,Middle East and Asia: Middle East: Other Middle East,85,45,40
E09000001,City of London,Middle East and Asia: South-East Asia: Other South-East Asia,148,129,19
E09000001,City of London,Middle East and Asia: South-East Asia: Philippines,49,36,13
E09000001,City of London,Middle East and Asia: Southern Asia: Bangladesh,117,98,19
E09000001,City of London,Middle East and Asia: Southern Asia: India,175,105,70
E09000001,City of London,Middle East and Asia: Southern Asia: Other Southern Asia,6,10,-4
E09000001,City of London,Middle East and Asia: Southern Asia: Pakistan,16,6,10
E09000001,City of London,Middle East and Asia: Southern Asia: Sri Lanka,11,7,4
E09000001,City of London,Other,0,0,0
E09000001,City of London,The Americas and the Caribbean: Central America: All Central American countries,28,8,20
E09000001,City of London,The Americas and the Caribbean: North America: Other North America,81,66,15
E09000001,City of London,The Americas and the Caribbean: North America: United States,266,205,61
E09000001,City of London,The Americas and the Caribbean: South America: All South American countries,238,114,124
E09000001,City of London,The Americas and the Caribbean: The Caribbean: Jamaica,7,6,1
E09000001,City of London,The Americas and the Caribbean: The Caribbean: Other Caribbean,26,24,2
E09000002,Barking and Dagenham,Africa: Africa not otherwise specified,33,119,-86
E09000002,Barking and Dagenham,Africa: Central and Western Africa: Ghana,3320,2673,647
E09000002,Barking and Dagenham,Africa: Central and Western Africa: Nigeria,9434,8695,739
E09000002,Barking and Dagenham,Africa: Central and Western Africa: Other Central and Western Africa,3489,2702,787
E09000002,Barking and Dagenham,Africa: North Africa,943,674,269
E09000002,Barking and Dagenham,Africa: South and Eastern Africa: Kenya,892,897,-5
E09000002,Barking and Dagenham,Africa: South and Eastern Africa: Other South and Eastern Africa,2266,2016,250
E09000002,Barking and Dagenham,Africa: South and Eastern Africa: Somalia,1311,1188,123
E09000002,Barking and Dagenham,Africa: South and Eastern Africa: South Africa,323,383,-60
E09000002,Barking and Dagenham,Africa: South and Eastern Africa: Zimbabwe,765,899,-134
E09000002,Barking and Dagenham,Antarctica and Oceania: Australasia: Australia,50,97,-47
E09000002,Barking and Dagenham,Antarctica and Oceania: Australasia: Other Australasia,55,86,-31
E09000002,Barking and Dagenham,Antarctica and Oceania: Other Oceania and Antarctica,35,18,17
E09000002,Barking and Dagenham,Europe: Other Europe: EU countries: Countries that joined the EU between April 2001 and March 2011: Lithuania,5494,4028,1466
E09000002,Barking and Dagenham,Europe: Other Europe: EU countries: Countries that joined the EU between April 2001 and March 2011: Other EU countries,4270,2014,2256
E09000002,Barking and Dagenham,Europe: Other Europe: EU countries: Countries that joined the EU between April 2001 and March 2011: Poland,2321,1811,510
E09000002,Barking and Dagenham,Europe: Other Europe: EU countries: Countries that joined the EU between April 2001 and March 2011: Romania,9416,1265,8151
E09000002,Barking and Dagenham,Europe: Other Europe: EU countries: Member countries in March 2001: France,471,477,-6
E09000002,Barking and Dagenham,Europe: Other Europe: EU countries: Member countries in March 2001: Germany,520,522,-2
E09000002,Barking and Dagenham,Europe: Other Europe: EU countries: Member countries in March 2001: Ireland,1072,1643,-571
E09000002,Barking and Dagenham,Europe: Other Europe: EU countries: Member countries in March 2001: Italy,2073,355,1718
E09000002,Barking and Dagenham,Europe: Other Europe: EU countries: Member countries in March 2001: Other member countries in March 2001,1124,723,401
E09000002,Barking and Dagenham,Europe: Other Europe: EU countries: Member countries in March 2001: Portugal (including Madeira and the Azores),1253,962,291
E09000002,Barking and Dagenham,Europe: Other Europe: EU countries: Member countries in March 2001: Spain (including Canary Islands),635,215,420
E09000002,Barking and Dagenham,Europe: Other Europe: Rest of Europe: Other Europe,6222,2642,3580
E09000002,Barking and Dagenham,Europe: Other Europe: Rest of Europe: Turkey,612,573,39
E09000002,Barking and Dagenham,Europe: United Kingdom: England,127430,126792,638
E09000002,Barking and Dagenham,Europe: United Kingdom: Great Britain not otherwise specified,3,13,-10
E09000002,Barking and Dagenham,Europe: United Kingdom: Northern Ireland,183,323,-140
E09000002,Barking and Dagenham,Europe: United Kingdom: Scotland,522,793,-271
E09000002,Barking and Dagenham,Europe: United Kingdom: United Kingdom not otherwise specified,28,58,-30
E09000002,Barking and Dagenham,Europe: United Kingdom: Wales,317,485,-168
E09000002,Barking and Dagenham,Middle East and Asia: Central Asia,72,59,13
E09000002,Barking and Dagenham,Middle East and Asia: Eastern Asia: China,551,424,127
E09000002,Barking and Dagenham,Middle East and Asia: Eastern Asia: Hong Kong (Special Administrative Region of China),265,229,36
E09000002,Barking and Dagenham,Middle East and Asia: Eastern Asia: Other Eastern Asia,89,81,8
E09000002,Barking and Dagenham,Middle East and Asia: Middle East: Iran,215,183,32
E09000002,Barking and Dagenham,Middle East and Asia: Middle East: Other Middle East,640,460,180
E09000002,Barking and Dagenham,Middle East and Asia: South-East Asia: Other South-East Asia,671,643,28
E09000002,Barking and Dagenham,Middle East and Asia: South-East Asia: Philippines,1122,1003,119
E09000002,Barking and Dagenham,Middle East and Asia: Southern Asia: Bangladesh,9290,3560,5730
E09000002,Barking and Dagenham,Middle East and Asia: Southern Asia: India,6677,4364,2313
E09000002,Barking and Dagenham,Middle East and Asia: Southern Asia: Other Southern Asia,801,439,362
E09000002,Barking and Dagenham,Middle East and Asia: Southern Asia: Pakistan,7275,4337,2938
E09000002,Barking and Dagenham,Middle East and Asia: Southern Asia: Sri Lanka,952,980,-28
E09000002,Barking and Dagenham,Other,0,0,0
E09000002,Barking and Dagenham,The Americas and the Caribbean: Central America: All Central American countries,36,26,10
E09000002,Barking and Dagenham,The Americas and the Caribbean: North America: Other North America,87,100,-13
E09000002,Barking and Dagenham,The Americas and the Caribbean: North America: United States,311,313,-2
E09000002,Barking and Dagenham,The Americas and the Caribbean: South America: All South American countries,881,544,337
E09000002,Barking and Dagenham,The Americas and the Caribbean: The Caribbean: Jamaica,970,964,6
E09000002,Barking and Dagenham,The Americas and the Caribbean: The Caribbean: Other Caribbean,1083,1061,22
E09000003,Barnet,Africa: Africa not otherwise specified,59,242,-183
E09000003,Barnet,Africa: Central and Western Africa: Ghana,2013,1885,128
E09000003,Barnet,Africa: Central and Western Africa: Nigeria,3846,3765,81
E09000003,Barnet,Africa: Central and Western Africa: Other Central and Western Africa,2446,2215,231
E09000003,Barnet,Africa: North Africa,3370,2549,821
E09000003,Barnet,Africa: South and Eastern Africa: Kenya,4384,4930,-546
E09000003,Barnet,Africa: South and Eastern Africa: Other South and Eastern Africa,4731,4890,-159
E09000003,Barnet,Africa: South and Eastern Africa: Somalia,2276,2345,-69
E09000003,Barnet,Africa: South and Eastern Africa: South Africa,3232,3518,-286
E09000003,Barnet,Africa: South and Eastern Africa: Zimbabwe,729,784,-55
E09000003,Barnet,Antarctica and Oceania: Australasia: Australia,1079,1207,-128
E09000003,Barnet,Antarctica and Oceania: Australasia: Other Australasia,418,533,-115
E09000003,Barnet,Antarctica and Oceania: Other Oceania and Antarctica,82,76,6
E09000003,Barnet,Europe: Other Europe: EU countries: Countries that joined the EU between April 2001 and March 2011: Lithuania,1148,1076,72
E09000003,Barnet,Europe: Other Europe: EU countries: Countries that joined the EU between April 2001 and March 2011: Other EU countries,10793,9776,1017
E09000003,Barnet,Europe: Other Europe: EU countries: Countries that joined the EU between April 2001 and March 2011: Poland,7551,8614,-1063
E09000003,Barnet,Europe: Other Europe: EU countries: Countries that joined the EU between April 2001 and March 2011: Romania,13430,4475,8955
E09000003,Barnet,Europe: Other Europe: EU countries: Member countries in March 2001: France,2109,1862,247
E09000003,Barnet,Europe: Other Europe: EU countries: Member countries in March 2001: Germany,1887,2304,-417
E09000003,Barnet,Europe: Other Europe: EU countries: Member countries in March 2001: Ireland,4681,6020,-1339
E09000003,Barnet,Europe: Other Europe: EU countries: Member countries in March 2001: Italy,4533,2747,1786
E09000003,Barnet,Europe: Other Europe: EU countries: Member countries in March 2001: Other member countries in March 2001,5405,3773,1632
E09000003,Barnet,Europe: Other Europe: EU countries: Member countries in March 2001: Portugal (including Madeira and the Azores),2248,1430,818
E09000003,Barnet,Europe: Other Europe: EU countries: Member countries in March 2001: Spain (including Canary Islands),1987,1086,901
E09000003,Barnet,Europe: Other Europe: Rest of Europe: Other Europe,11204,5799,5405
E09000003,Barnet,Europe: Other Europe: Rest of Europe: Turkey,2811,1952,859
E09000003,Barnet,Europe: United Kingdom: England,215835,211249,4586
E09000003,Barnet,Europe: United Kingdom: Great Britain not otherwise specified,2,9,-7
E09000003,Barnet,Europe: United Kingdom: Northern Ireland,998,1247,-249
E09000003,Barnet,Europe: United Kingdom: Scotland,2808,3280,-472
E09000003,Barnet,Europe: United Kingdom: United Kingdom not otherwise specified,24,57,-33
E09000003,Barnet,Europe: United Kingdom: Wales,1626,2048,-422
E09000003,Barnet,Middle East and Asia: Central Asia,518,224,294
E09000003,Barnet,Middle East and Asia: Eastern Asia: China,3074,2598,476
E09000003,Barnet,Middle East and Asia: Eastern Asia: Hong Kong (Special Administrative Region of China),2400,1860,540
E09000003,Barnet,Middle East and Asia: Eastern Asia: Other Eastern Asia,2821,3413,-592
E09000003,Barnet,Middle East and Asia: Middle East: Iran,11227,7242,3985
E09000003,Barnet,Middle East and Asia: Middle East: Other Middle East,9843,7829,2014
E09000003,Barnet,Middle East and Asia: South-East Asia: Other South-East Asia,3110,3075,35
E09000003,Barnet,Middle East and Asia: South-East Asia: Philippines,3902,2825,1077
E09000003,Barnet,Middle East and Asia: Southern Asia: Bangladesh,1282,1119,163
E09000003,Barnet,Middle East and Asia: Southern Asia: India,11335,10912,423
E09000003,Barnet,Middle East and Asia: Southern Asia: Other Southern Asia,4493,4018,475
E09000003,Barnet,Middle East and Asia: Southern Asia: Pakistan,3042,2719,323
E09000003,Barnet,Middle East and Asia: Southern Asia: Sri Lanka,2564,2810,-246
E09000003,Barnet,Other,1,1,0
E09000003,Barnet,The Americas and the Caribbean: Central America: All Central American countries,291,155,136
E09000003,Barnet,The Americas and the Caribbean: North America: Other North America,708,663,45
E09000003,Barnet,The Americas and the Caribbean: North America: United States,2470,2246,224
E09000003,Barnet,The Americas and the Caribbean: South America: All South American countries,4758,3036,1722
E09000003,Barnet,The Americas and the Caribbean: The Caribbean: Jamaica,872,891,-19
E09000003,Barnet,The Americas and the Caribbean: The Caribbean: Other Caribbean,886,1007,-121
E09000004,Bexley,Africa: Africa not otherwise specified,30,80,-50
E09000004,Bexley,Africa: Central and Western Africa: Ghana,1640,1169,471
E09000004,Bexley,Africa: Central and Western Africa: Nigeria,8831,6011,2820
E09000004,Bexley,Africa: Central and Western Africa: Other Central and Western Africa,1400,925,475
E09000004,Bexley,Africa: North Africa,465,317,148
E09000004,Bexley,Africa: South and Eastern Africa: Kenya,826,835,-9
E09000004,Bexley,Africa: South and Eastern Africa: Other South and Eastern Africa,1470,1253,217
E09000004,Bexley,Africa: South and Eastern Africa: Somalia,90,118,-28
E09000004,Bexley,Africa: South and Eastern Africa: South Africa,679,610,69
E09000004,Bexley,Africa: South and Eastern Africa: Zimbabwe,628,789,-161
E09000004,Bexley,Antarctica and Oceania: Australasia: Australia,275,246,29
E09000004,Bexley,Antarctica and Oceania: Australasia: Other Australasia,126,109,17
E09000004,Bexley,Antarctica and Oceania: Other Oceania and Antarctica,25,17,8
E09000004,Bexley,Europe: Other Europe: EU countries: Countries that joined the EU between April 2001 and March 2011: Lithuania,1280,629,651
E09000004,Bexley,Europe: Other Europe: EU countries: Countries that joined the EU between April 2001 and March 2011: Other EU countries,2979,1544,1435
E09000004,Bexley,Europe: Other Europe: EU countries: Countries that joined the EU between April 2001 and March 2011: Poland,2082,1070,1012
E09000004,Bexley,Europe: Other Europe: EU countries: Countries that joined the EU between April 2001 and March 2011: Romania,2415,242,2173
E09000004,Bexley,Europe: Other Europe: EU countries: Member countries in March 2001: France,533,363,170
E09000004,Bexley,Europe: Other Europe: EU countries: Member countries in March 2001: Germany,629,623,6
E09000004,Bexley,Europe: Other Europe: EU countries: Member countries in March 2001: Ireland,1871,2103,-232
E09000004,Bexley,Europe: Other Europe: EU countries: Member countries in March 2001: Italy,1018,416,602
E09000004,Bexley,Europe: Other Europe: EU countries: Member countries in March 2001: Other member countries in March 2001,866,650,216
E09000004,Bexley,Europe: Other Europe: EU countries: Member countries in March 2001: Portugal (including Madeira and the Azores),483,227,256
E09000004,Bexley,Europe: Other Europe: EU countries: Member countries in March 2001: Spain (including Canary Islands),483,232,251
E09000004,Bexley,Europe: Other Europe: Rest of Europe: Other Europe,2483,979,1504
E09000004,Bexley,Europe: Other Europe: Rest of Europe: Turkey,655,402,253
E09000004,Bexley,Europe: United Kingdom: England,191843,195881,-4038
E09000004,Bexley,Europe: United Kingdom: Great Britain not otherwise specified,3,11,-8
E09000004,Bexley,Europe: United Kingdom: Northern Ireland,479,563,-84
E09000004,Bexley,Europe: United Kingdom: Scotland,1464,1785,-321
E09000004,Bexley,Europe: United Kingdom: United Kingdom not otherwise specified,14,26,-12
E09000004,Bexley,Europe: United Kingdom: Wales,910,1101,-191
E09000004,Bexley,Middle East and Asia: Central Asia,165,58,107
E09000004,Bexley,Middle East and Asia: Eastern Asia: China,1143,516,627
E09000004,Bexley,Middle East and Asia: Eastern Asia: Hong Kong (Special Administrative Region of China),744,557,187
E09000004,Bexley,Middle East and Asia: Eastern Asia: Other Eastern Asia,181,90,91
E09000004,Bexley,Middle East and Asia: Middle East: Iran,178,144,34
E09000004,Bexley,Middle East and Asia: Middle East: Other Middle East,496,343,153
E09000004,Bexley,Middle East and Asia: South-East Asia: Other South-East Asia,1462,1166,296
E09000004,Bexley,Middle East and Asia: South-East Asia: Philippines,411,280,131
E09000004,Bexley,Middle East and Asia: Southern Asia: Bangladesh,829,390,439
E09000004,Bexley,Middle East and Asia: Southern Asia: India,5488,3403,2085
E09000004,Bexley,Middle East and Asia: Southern Asia: Other Southern Asia,1502,296,1206
E09000004,Bexley,Middle East and Asia: Southern Asia: Pakistan,685,367,318
E09000004,Bexley,Middle East and Asia: Southern Asia: Sri Lanka,1309,998,311
E09000004,Bexley,Other,1,0,1
E09000004,Bexley,The Americas and the Caribbean: Central America: All Central American countries,35,20,15
E09000004,Bexley,The Americas and the Caribbean: North America: Other North America,163,169,-6
E09000004,Bexley,The Americas and the Caribbean: North America: United States,511,356,155
E09000004,Bexley,The Americas and the Caribbean: South America: All South American countries,1037,503,534
E09000004,Bexley,The Americas and the Caribbean: The Caribbean: Jamaica,691,579,112
E09000004,Bexley,The Americas and the Caribbean: The Caribbean: Other Caribbean,466,436,30
E09000005,Brent,Africa: Africa not otherwise specified,126,541,-415
E09000005,Brent,Africa: Central and Western Africa: Ghana,2358,2680,-322
E09000005,Brent,Africa: Central and Western Africa: Nigeria,2559,2911,-352
E09000005,Brent,Africa: Central and Western Africa: Other Central and Western Africa,2158,2038,120
E09000005,Brent,Africa: North Africa,5304,3591,1713
E09000005,Brent,Africa: South and Eastern Africa: Kenya,6370,7382,-1012
E09000005,Brent,Africa: South and Eastern Africa: Other South and Eastern Africa,6730,7023,-293
E09000005,Brent,Africa: South and Eastern Africa: Somalia,6678,6855,-177
E09000005,Brent,Africa: South and Eastern Africa: South Africa,862,1123,-261
E09000005,Brent,Africa: South and Eastern Africa: Zimbabwe,372,395,-23
E09000005,Brent,Antarctica and Oceania: Australasia: Australia,900,1315,-415
E09000005,Brent,Antarctica and Oceania: Australasia: Other Australasia,498,1056,-558
E09000005,Brent,Antarctica and Oceania: Other Oceania and Antarctica,199,230,-31
E09000005,Brent,Europe: Other Europe: EU countries: Countries that joined the EU between April 2001 and March 2011: Lithuania,830,1064,-234
E09000005,Brent,Europe: Other Europe: EU countries: Countries that joined the EU between April 2001 and March 2011: Other EU countries,5240,4810,430
E09000005,Brent,Europe: Other Europe: EU countries: Countries that joined the EU between April 2001 and March 2011: Poland,7235,10575,-3340
E09000005,Brent,Europe: Other Europe: EU countries: Countries that joined the EU between April 2001 and March 2011: Romania,17722,6182,11540
E09000005,Brent,Europe: Other Europe: EU countries: Member countries in March 2001: France,2339,1762,577
E09000005,Brent,Europe: Other Europe: EU countries: Member countries in March 2001: Germany,1211,1385,-174
E09000005,Brent,Europe: Other Europe: EU countries: Member countries in March 2001: Ireland,5850,8874,-3024
E09000005,Brent,Europe: Other Europe: EU countries: Member countries in March 2001: Italy,4662,2337,2325
E09000005,Brent,Europe: Other Europe: EU countries: Member countries in March 2001: Other member countries in March 2001,3605,3011,594
E09000005,Brent,Europe: Other Europe: EU countries: Member countries in March 2001: Portugal (including Madeira and the Azores),3528,3076,452
E09000005,Brent,Europe: Other Europe: EU countries: Member countries in March 2001: Spain (including Canary Islands),2670,1447,1223
E09000005,Brent,Europe: Other Europe: Rest of Europe: Other Europe,5193,3184,2009
E09000005,Brent,Europe: Other Europe: Rest of Europe: Turkey,669,372,297
E09000005,Brent,Europe: United Kingdom: England,145986,135712,10274
E09000005,Brent,Europe: United Kingdom: Great Britain not otherwise specified,5,29,-24
E09000005,Brent,Europe: United Kingdom: Northern Ireland,832,999,-167
E09000005,Brent,Europe: United Kingdom: Scotland,1405,1838,-433
E09000005,Brent,Europe: United Kingdom: United Kingdom not otherwise specified,52,102,-50
E09000005,Brent,Europe: United Kingdom: Wales,962,1108,-146
E09000005,Brent,Middle East and Asia: Central Asia,113,177,-64
E09000005,Brent,Middle East and Asia: Eastern Asia: China,1328,1015,313
E09000005,Brent,Middle East and Asia: Eastern Asia: Hong Kong (Special Administrative Region of China),891,847,44
E09000005,Brent,Middle East and Asia: Eastern Asia: Other Eastern Asia,685,672,13
E09000005,Brent,Middle East and Asia: Middle East: Iran,2192,2085,107
E09000005,Brent,Middle East and Asia: Middle East: Other Middle East,11592,7710,3882
E09000005,Brent,Middle East and Asia: South-East Asia: Other South-East Asia,1893,2132,-239
E09000005,Brent,Middle East and Asia: South-East Asia: Philippines,4415,3564,851
E09000005,Brent,Middle East and Asia: Southern Asia: Bangladesh,958,875,83
E09000005,Brent,Middle East and Asia: Southern Asia: India,35203,28548,6655
E09000005,Brent,Middle East and Asia: Southern Asia: Other Southern Asia,5009,5987,-978
E09000005,Brent,Middle East and Asia: Southern Asia: Pakistan,6585,6809,-224
E09000005,Brent,Middle East and Asia: Southern Asia: Sri Lanka,5672,7702,-2030
E09000005,Brent,Other,0,0,0
E09000005,Brent,The Americas and the Caribbean: Central America: All Central American countries,200,133,67
E09000005,Brent,The Americas and the Caribbean: North America: Other North America,502,430,72
E09000005,Brent,The Americas and the Caribbean: North America: United States,1501,1135,366
E09000005,Brent,The Americas and the Caribbean: South America: All South American countries,7606,5289,2317
E09000005,Brent,The Americas and the Caribbean: The Caribbean: Jamaica,5423,7189,-1766
E09000005,Brent,The Americas and the Caribbean: The Caribbean: Other Caribbean,2939,3909,-970
E09000006,Bromley,Africa: Africa not otherwise specified,13,82,-69
E09000006,Bromley,Africa: Central and Western Africa: Ghana,1128,863,265
E09000006,Bromley,Africa: Central and Western Africa: Nigeria,3515,2299,1216
E09000006,Bromley,Africa: Central and Western Africa: Other Central and Western Africa,1273,931,342
E09000006,Bromley,Africa: North Africa,1006,787,219
E09000006,Bromley,Africa: South and Eastern Africa: Kenya,846,832,14
E09000006,Bromley,Africa: South and Eastern Africa: Other South and Eastern Africa,1809,1629,180
E09000006,Bromley,Africa: South and Eastern Africa: Somalia,257,288,-31
E09000006,Bromley,Africa: South and Eastern Africa: South Africa,1939,1801,138
E09000006,Bromley,Africa: South and Eastern Africa: Zimbabwe,824,825,-1
E09000006,Bromley,Antarctica and Oceania: Australasia: Australia,1026,852,174
E09000006,Bromley,Antarctica and Oceania: Australasia: Other Australasia,544,503,41
E09000006,Bromley,Antarctica and Oceania: Other Oceania and Antarctica,45,16,29
E09000006,Bromley,Europe: Other Europe: EU countries: Countries that joined the EU between April 2001 and March 2011: Lithuania,1116,539,577
E09000006,Bromley,Europe: Other Europe: EU countries: Countries that joined the EU between April 2001 and March 2011: Other EU countries,3823,2368,1455
E09000006,Bromley,Europe: Other Europe: EU countries: Countries that joined the EU between April 2001 and March 2011: Poland,2826,1903,923
E09000006,Bromley,Europe: Other Europe: EU countries: Countries that joined the EU between April 2001 and March 2011: Romania,2426,452,1974
E09000006,Bromley,Europe: Other Europe: EU countries: Member countries in March 2001: France,1403,957,446
E09000006,Bromley,Europe: Other Europe: EU countries: Member countries in March 2001: Germany,1285,1268,17
E09000006,Bromley,Europe: Other Europe: EU countries: Member countries in March 2001: Ireland,2942,3256,-314
E09000006,Bromley,Europe: Other Europe: EU countries: Member countries in March 2001: Italy,1872,971,901
E09000006,Bromley,Europe: Other Europe: EU countries: Member countries in March 2001: Other member countries in March 2001,1921,1397,524
E09000006,Bromley,Europe: Other Europe: EU countries: Member countries in March 2001: Portugal (including Madeira and the Azores),994,422,572
E09000006,Bromley,Europe: Other Europe: EU countries: Member countries in March 2001: Spain (including Canary Islands),1064,500,564
E09000006,Bromley,Europe: Other Europe: Rest of Europe: Other Europe,3799,1923,1876
E09000006,Bromley,Europe: Other Europe: Rest of Europe: Turkey,1073,570,503
E09000006,Bromley,Europe: United Kingdom: England,256209,257039,-830
E09000006,Bromley,Europe: United Kingdom: Great Britain not otherwise specified,1,10,-9
E09000006,Bromley,Europe: United Kingdom: Northern Ireland,1102,1112,-10
E09000006,Bromley,Europe: United Kingdom: Scotland,3572,4070,-498
E09000006,Bromley,Europe: United Kingdom: United Kingdom not otherwise specified,8,26,-18
E09000006,Bromley,Europe: United Kingdom: Wales,2160,2391,-231
E09000006,Bromley,Middle East and Asia: Central Asia,149,81,68
E09000006,Bromley,Middle East and Asia: Eastern Asia: China,1738,736,1002
E09000006,Bromley,Middle East and Asia: Eastern Asia: Hong Kong (Special Administrative Region of China),1007,722,285
E09000006,Bromley,Middle East and Asia: Eastern Asia: Other Eastern Asia,602,437,165
E09000006,Bromley,Middle East and Asia: Middle East: Iran,604,478,126
E09000006,Bromley,Middle East and Asia: Middle East: Other Middle East,982,801,181
E09000006,Bromley,Middle East and Asia: South-East Asia: Other South-East Asia,1910,1392,518
E09000006,Bromley,Middle East and Asia: South-East Asia: Philippines,1324,721,603
E09000006,Bromley,Middle East and Asia: Southern Asia: Bangladesh,713,618,95
E09000006,Bromley,Middle East and Asia: Southern Asia: India,6842,3474,3368
E09000006,Bromley,Middle East and Asia: Southern Asia: Other Southern Asia,422,241,181
E09000006,Bromley,Middle East and Asia: Southern Asia: Pakistan,822,541,281
E09000006,Bromley,Middle East and Asia: Southern Asia: Sri Lanka,1514,1200,314
E09000006,Bromley,Other,0,2,-2
E09000006,Bromley,The Americas and the Caribbean: Central America: All Central American countries,145,98,47
E09000006,Bromley,The Americas and the Caribbean: North America: Other North America,548,475,73
E09000006,Bromley,The Americas and the Caribbean: North America: United States,1225,961,264
E09000006,Bromley,The Americas and the Caribbean: South America: All South American countries,3069,1380,1689
E09000006,Bromley,The Americas and the Caribbean: The Caribbean: Jamaica,1753,1456,297
E09000006,Bromley,The Americas and the Caribbean: The Caribbean: Other Caribbean,794,696,98
E09000007,Camden,Africa: Africa not otherwise specified,24,74,-50
E09000007,Camden,Africa: Central and Western Africa: Ghana,576,593,-17
E09000007,Camden,Africa: Central and Western Africa: Nigeria,1063,1060,3
E09000007,Camden,Africa: Central and Western Africa: Other Central and Western Africa,1333,1263,70
E09000007,Camden,Africa: North Africa,2415,1987,428
E09000007,Camden,Africa: South and Eastern Africa: Kenya,491,549,-58
E09000007,Camden,Africa: South and Eastern Africa: Other South and Eastern Africa,2237,2267,-30
E09000007,Camden,Africa: South and Eastern Africa: Somalia,2954,2879,75
E09000007,Camden,Africa: South and Eastern Africa: South Africa,1735,2304,-569
E09000007,Camden,Africa: South and Eastern Africa: Zimbabwe,270,318,-48
E09000007,Camden,Antarctica and Oceania: Australasia: Australia,2069,3499,-1430
E09000007,Camden,Antarctica and Oceania: Australasia: Other Australasia,758,1687,-929
E09000007,Camden,Antarctica and Oceania: Other Oceania and Antarctica,40,53,-13
E09000007,Camden,Europe: Other Europe: EU countries: Countries that joined the EU between April 2001 and March 2011: Lithuania,449,253,196
E09000007,Camden,Europe: Other Europe: EU countries: Countries that joined the EU between April 2001 and March 2011: Other EU countries,3078,2932,146
E09000007,Camden,Europe: Other Europe: EU countries: Countries that joined the EU between April 2001 and March 2011: Poland,1901,2285,-384
E09000007,Camden,Europe: Other Europe: EU countries: Countries that joined the EU between April 2001 and March 2011: Romania,1115,405,710
E09000007,Camden,Europe: Other Europe: EU countries: Member countries in March 2001: France,5265,3742,1523
E09000007,Camden,Europe: Other Europe: EU countries: Member countries in March 2001: Germany,2408,2993,-585
E09000007,Camden,Europe: Other Europe: EU countries: Member countries in March 2001: Ireland,3064,5211,-2147
E09000007,Camden,Europe: Other Europe: EU countries: Member countries in March 2001: Italy,4442,3238,1204
E09000007,Camden,Europe: Other Europe: EU countries: Member countries in March 2001: Other member countries in March 2001,4814,4674,140
E09000007,Camden,Europe: Other Europe: EU countries: Member countries in March 2001: Portugal (including Madeira and the Azores),1298,1133,165
E09000007,Camden,Europe: Other Europe: EU countries: Member countries in March 2001: Spain (including Canary Islands),2309,1712,597
E09000007,Camden,Europe: Other Europe: Rest of Europe: Other Europe,6672,5894,778
E09000007,Camden,Europe: Other Europe: Rest of Europe: Turkey,1224,799,425
E09000007,Camden,Europe: United Kingdom: England,109871,119565,-9694
E09000007,Camden,Europe: United Kingdom: Great Britain not otherwise specified,2,50,-48
E09000007,Camden,Europe: United Kingdom: Northern Ireland,919,1309,-390
E09000007,Camden,Europe: United Kingdom: Scotland,2481,3708,-1227
E09000007,Camden,Europe: United Kingdom: United Kingdom not otherwise specified,12,49,-37
E09000007,Camden,Europe: United Kingdom: Wales,1362,2014,-652
E09000007,Camden,Middle East and Asia: Central Asia,254,253,1
E09000007,Camden,Middle East and Asia: Eastern Asia: China,3111,2036,1075
E09000007,Camden,Middle East and Asia: Eastern Asia: Hong Kong (Special Administrative Region of China),1343,1264,79
E09000007,Camden,Middle East and Asia: Eastern Asia: Other Eastern Asia,2502,2923,-421
E09000007,Camden,Middle East and Asia: Middle East: Iran,1943,1752,191
E09000007,Camden,Middle East and Asia: Middle East: Other Middle East,3955,3320,635
E09000007,Camden,Middle East and Asia: South-East Asia: Other South-East Asia,2755,3290,-535
E09000007,Camden,Middle East and Asia: South-East Asia: Philippines,2063,1730,333
E09000007,Camden,Middle East and Asia: Southern Asia: Bangladesh,5814,5947,-133
E09000007,Camden,Middle East and Asia: Southern Asia: India,3270,2667,603
E09000007,Camden,Middle East and Asia: Southern Asia: Other Southern Asia,683,694,-11
E09000007,Camden,Middle East and Asia: Southern Asia: Pakistan,768,716,52
E09000007,Camden,Middle East and Asia: Southern Asia: Sri Lanka,318,459,-141
E09000007,Camden,Other,0,4,-4
E09000007,Camden,The Americas and the Caribbean: Central America: All Central American countries,492,386,106
E09000007,Camden,The Americas and the Caribbean: North America: Other North America,1412,1778,-366
E09000007,Camden,The Americas and the Caribbean: North America: United States,5912,6264,-352
E09000007,Camden,The Americas and the Caribbean: South America: All South American countries,3839,3138,701
E09000007,Camden,The Americas and the Caribbean: The Caribbean: Jamaica,350,406,-56
E09000007,Camden,The Americas and the Caribbean: The Caribbean: Other Caribbean,700,812,-112
E09000008,Croydon,Africa: Africa not otherwise specified,63,326,-263
E09000008,Croydon,Africa: Central and Western Africa: Ghana,7244,5363,1881
E09000008,Croydon,Africa: Central and Western Africa: Nigeria,6185,4715,1470
E09000008,Croydon,Africa: Central and Western Africa: Other Central and Western Africa,4473,3260,1213
E09000008,Croydon,Africa: North Africa,1679,1312,367
E09000008,Croydon,Africa: South and Eastern Africa: Kenya,3088,3390,-302
E09000008,Croydon,Africa: South and Eastern Africa: Other South and Eastern Africa,7054,7033,21
E09000008,Croydon,Africa: South and Eastern Africa: Somalia,1226,1038,188
E09000008,Croydon,Africa: South and Eastern Africa: South Africa,1551,1616,-65
E09000008,Croydon,Africa: South and Eastern Africa: Zimbabwe,1144,1294,-150
E09000008,Croydon,Antarctica and Oceania: Australasia: Australia,722,598,124
E09000008,Croydon,Antarctica and Oceania: Australasia: Other Australasia,370,368,2
E09000008,Croydon,Antarctica and Oceania: Other Oceania and Antarctica,97,55,42
E09000008,Croydon,Europe: Other Europe: EU countries: Countries that joined the EU between April 2001 and March 2011: Lithuania,1088,802,286
E09000008,Croydon,Europe: Other Europe: EU countries: Countries that joined the EU between April 2001 and March 2011: Other EU countries,5421,3557,1864
E09000008,Croydon,Europe: Other Europe: EU countries: Countries that joined the EU between April 2001 and March 2011: Poland,7979,5233,2746
E09000008,Croydon,Europe: Other Europe: EU countries: Countries that joined the EU between April 2001 and March 2011: Romania,4860,880,3980
E09000008,Croydon,Europe: Other Europe: EU countries: Member countries in March 2001: France,1682,1269,413
E09000008,Croydon,Europe: Other Europe: EU countries: Member countries in March 2001: Germany,1581,1561,20
E09000008,Croydon,Europe: Other Europe: EU countries: Member countries in March 2001: Ireland,3164,4055,-891
E09000008,Croydon,Europe: Other Europe: EU countries: Member countries in March 2001: Italy,3268,1446,1822
E09000008,Croydon,Europe: Other Europe: EU countries: Member countries in March 2001: Other member countries in March 2001,2478,1628,850
E09000008,Croydon,Europe: Other Europe: EU countries: Member countries in March 2001: Portugal (including Madeira and the Azores),3104,1283,1821
E09000008,Croydon,Europe: Other Europe: EU countries: Member countries in March 2001: Spain (including Canary Islands),1982,740,1242
E09000008,Croydon,Europe: Other Europe: Rest of Europe: Other Europe,3870,1958,1912
E09000008,Croydon,Europe: Other Europe: Rest of Europe: Turkey,1507,1382,125
E09000008,Croydon,Europe: United Kingdom: England,249371,249667,-296
E09000008,Croydon,Europe: United Kingdom: Great Britain not otherwise specified,4,30,-26
E09000008,Croydon,Europe: United Kingdom: Northern Ireland,924,998,-74
E09000008,Croydon,Europe: United Kingdom: Scotland,2564,3201,-637
E09000008,Croydon,Europe: United Kingdom: United Kingdom not otherwise specified,24,71,-47
E09000008,Croydon,Europe: United Kingdom: Wales,1649,1927,-278
E09000008,Croydon,Middle East and Asia: Central Asia,125,67,58
E09000008,Croydon,Middle East and Asia: Eastern Asia: China,1203,1164,39
E09000008,Croydon,Middle East and Asia: Eastern Asia: Hong Kong (Special Administrative Region of China),818,728,90
E09000008,Croydon,Middle East and Asia: Eastern Asia: Other Eastern Asia,609,612,-3
E09000008,Croydon,Middle East and Asia: Middle East: Iran,902,814,88
E09000008,Croydon,Middle East and Asia: Middle East: Other Middle East,1907,1569,338
E09000008,Croydon,Middle East and Asia: South-East Asia: Other South-East Asia,2338,2220,118
E09000008,Croydon,Middle East and Asia: South-East Asia: Philippines,1437,1150,287
E09000008,Croydon,Middle East and Asia: Southern Asia: Bangladesh,1468,1179,289
E09000008,Croydon,Middle East and Asia: Southern Asia: India,14374,13220,1154
E09000008,Croydon,Middle East and Asia: Southern Asia: Other Southern Asia,1666,1510,156
E09000008,Croydon,Middle East and Asia: Southern Asia: Pakistan,6960,5343,1617
E09000008,Croydon,Middle East and Asia: Southern Asia: Sri Lanka,5165,5270,-105
E09000008,Croydon,Other,2,2,0
E09000008,Croydon,The Americas and the Caribbean: Central America: All Central American countries,218,123,95
E09000008,Croydon,The Americas and the Caribbean: North America: Other North America,470,426,44
E09000008,Croydon,The Americas and the Caribbean: North America: United States,1171,857,314
E09000008,Croydon,The Americas and the Caribbean: South America: All South American countries,6118,3270,2848
E09000008,Croydon,The Americas and the Caribbean: The Caribbean: Jamaica,9397,9240,157
E09000008,Croydon,The Americas and the Caribbean: The Caribbean: Other Caribbean,2955,2558,397
E09000009,Ealing,Africa: Africa not otherwise specified,131,486,-355
E09000009,Ealing,Africa: Central and Western Africa: Ghana,1048,1125,-77
E09000009,Ealing,Africa: Central and Western Africa: Nigeria,1603,1413,190
E09000009,Ealing,Africa: Central and Western Africa: Other Central and Western Africa,1124,911,213
E09000009,Ealing,Africa: North Africa,4271,2757,1514
E09000009,Ealing,Africa: South and Eastern Africa: Kenya,3760,4404,-644
E09000009,Ealing,Africa: South and Eastern Africa: Other South and Eastern Africa,4945,4756,189
E09000009,Ealing,Africa: South and Eastern Africa: Somalia,5848,6468,-620
E09000009,Ealing,Africa: South and Eastern Africa: South Africa,1437,2064,-627
E09000009,Ealing,Africa: South and Eastern Africa: Zimbabwe,460,625,-165
E09000009,Ealing,Antarctica and Oceania: Australasia: Australia,1264,2015,-751
E09000009,Ealing,Antarctica and Oceania: Australasia: Other Australasia,835,1556,-721
E09000009,Ealing,Antarctica and Oceania: Other Oceania and Antarctica,162,144,18
E09000009,Ealing,Europe: Other Europe: EU countries: Countries that joined the EU between April 2001 and March 2011: Lithuania,1215,1292,-77
E09000009,Ealing,Europe: Other Europe: EU countries: Countries that joined the EU between April 2001 and March 2011: Other EU countries,5544,4456,1088
E09000009,Ealing,Europe: Other Europe: EU countries: Countries that joined the EU between April 2001 and March 2011: Poland,18816,21507,-2691
E09000009,Ealing,Europe: Other Europe: EU countries: Countries that joined the EU between April 2001 and March 2011: Romania,4986,1028,3958
E09000009,Ealing,Europe: Other Europe: EU countries: Member countries in March 2001: France,2780,2523,257
E09000009,Ealing,Europe: Other Europe: EU countries: Member countries in March 2001: Germany,1630,1812,-182
E09000009,Ealing,Europe: Other Europe: EU countries: Member countries in March 2001: Ireland,5316,7665,-2349
E09000009,Ealing,Europe: Other Europe: EU countries: Member countries in March 2001: Italy,5243,1988,3255
E09000009,Ealing,Europe: Other Europe: EU countries: Member countries in March 2001: Other member countries in March 2001,4209,3107,1102
E09000009,Ealing,Europe: Other Europe: EU countries: Member countries in March 2001: Portugal (including Madeira and the Azores),2212,1341,871
E09000009,Ealing,Europe: Other Europe: EU countries: Member countries in March 2001: Spain (including Canary Islands),2409,1270,1139
E09000009,Ealing,Europe: Other Europe: Rest of Europe: Other Europe,7845,4455,3390
E09000009,Ealing,Europe: Other Europe: Rest of Europe: Turkey,769,449,320
E09000009,Ealing,Europe: United Kingdom: England,174861,168302,6559
E09000009,Ealing,Europe: United Kingdom: Great Britain not otherwise specified,0,17,-17
E09000009,Ealing,Europe: United Kingdom: Northern Ireland,1156,1378,-222
E09000009,Ealing,Europe: United Kingdom: Scotland,2693,3207,-514
E09000009,Ealing,Europe: United Kingdom: United Kingdom not otherwise specified,33,105,-72
E09000009,Ealing,Europe: United Kingdom: Wales,1818,2212,-394
E09000009,Ealing,Middle East and Asia: Central Asia,188,193,-5
E09000009,Ealing,Middle East and Asia: Eastern Asia: China,1529,1173,356
E09000009,Ealing,Middle East and Asia: Eastern Asia: Hong Kong (Special Administrative Region of China),1378,1046,332
E09000009,Ealing,Middle East and Asia: Eastern Asia: Other Eastern Asia,3426,2803,623
E09000009,Ealing,Middle East and Asia: Middle East: Iran,3796,3440,356
E09000009,Ealing,Middle East and Asia: Middle East: Other Middle East,12368,8645,3723
E09000009,Ealing,Middle East and Asia: South-East Asia: Other South-East Asia,2712,2837,-125
E09000009,Ealing,Middle East and Asia: South-East Asia: Philippines,2059,1644,415
E09000009,Ealing,Middle East and Asia: Southern Asia: Bangladesh,2111,997,1114
E09000009,Ealing,Middle East and Asia: Southern Asia: India,31819,25820,5999
E09000009,Ealing,Middle East and Asia: Southern Asia: Other Southern Asia,9665,8361,1304
E09000009,Ealing,Middle East and Asia: Southern Asia: Pakistan,7757,7356,401
E09000009,Ealing,Middle East and Asia: Southern Asia: Sri Lanka,6020,6687,-667
E09000009,Ealing,Other,3,3,0
E09000009,Ealing,The Americas and the Caribbean: Central America: All Central American countries,226,166,60
E09000009,Ealing,The Americas and the Caribbean: North America: Other North America,760,756,4
E09000009,Ealing,The Americas and the Caribbean: North America: United States,1900,1596,304
E09000009,Ealing,The Americas and the Caribbean: South America: All South American countries,4109,2467,1642
E09000009,Ealing,The Americas and the Caribbean: The Caribbean: Jamaica,1983,2269,-286
E09000009,Ealing,The Americas and the Caribbean: The Caribbean: Other Caribbean,2884,3352,-468
E09000010,Enfield,Africa: Africa not otherwise specified,57,198,-141
E09000010,Enfield,Africa: Central and Western Africa: Ghana,4738,4089,649
E09000010,Enfield,Africa: Central and Western Africa: Nigeria,3861,4114,-253
E09000010,Enfield,Africa: Central and Western Africa: Other Central and Western Africa,3690,3144,546
E09000010,Enfield,Africa: North Africa,1608,1248,360
E09000010,Enfield,Africa: South and Eastern Africa: Kenya,1897,2152,-255
E09000010,Enfield,Africa: South and Eastern Africa: Other South and Eastern Africa,6325,6233,92
E09000010,Enfield,Africa: South and Eastern Africa: Somalia,3807,3297,510
E09000010,Enfield,Africa: South and Eastern Africa: South Africa,725,898,-173
E09000010,Enfield,Africa: South and Eastern Africa: Zimbabwe,547,862,-315
E09000010,Enfield,Antarctica and Oceania: Australasia: Australia,422,425,-3
E09000010,Enfield,Antarctica and Oceania: Australasia: Other Australasia,199,245,-46
E09000010,Enfield,Antarctica and Oceania: Other Oceania and Antarctica,55,42,13
E09000010,Enfield,Europe: Other Europe: EU countries: Countries that joined the EU between April 2001 and March 2011: Lithuania,831,875,-44
E09000010,Enfield,Europe: Other Europe: EU countries: Countries that joined the EU between April 2001 and March 2011: Other EU countries,20324,14891,5433
E09000010,Enfield,Europe: Other Europe: EU countries: Countries that joined the EU between April 2001 and March 2011: Poland,5894,6011,-117
E09000010,Enfield,Europe: Other Europe: EU countries: Countries that joined the EU between April 2001 and March 2011: Romania,6812,1698,5114
E09000010,Enfield,Europe: Other Europe: EU countries: Member countries in March 2001: France,790,845,-55
E09000010,Enfield,Europe: Other Europe: EU countries: Member countries in March 2001: Germany,862,990,-128
E09000010,Enfield,Europe: Other Europe: EU countries: Member countries in March 2001: Ireland,3283,4382,-1099
E09000010,Enfield,Europe: Other Europe: EU countries: Member countries in March 2001: Italy,3167,2607,560
E09000010,Enfield,Europe: Other Europe: EU countries: Member countries in March 2001: Other member countries in March 2001,4490,2222,2268
E09000010,Enfield,Europe: Other Europe: EU countries: Member countries in March 2001: Portugal (including Madeira and the Azores),1207,751,456
E09000010,Enfield,Europe: Other Europe: EU countries: Member countries in March 2001: Spain (including Canary Islands),1129,541,588
E09000010,Enfield,Europe: Other Europe: Rest of Europe: Other Europe,9048,4320,4728
E09000010,Enfield,Europe: Other Europe: Rest of Europe: Turkey,17053,13968,3085
E09000010,Enfield,Europe: United Kingdom: England,193733,198645,-4912
E09000010,Enfield,Europe: United Kingdom: Great Britain not otherwise specified,11,15,-4
E09000010,Enfield,Europe: United Kingdom: Northern Ireland,658,826,-168
E09000010,Enfield,Europe: United Kingdom: Scotland,1516,2119,-603
E09000010,Enfield,Europe: United Kingdom: United Kingdom not otherwise specified,25,78,-53
E09000010,Enfield,Europe: United Kingdom: Wales,881,1185,-304
E09000010,Enfield,Middle East and Asia: Central Asia,190,106,84
E09000010,Enfield,Middle East and Asia: Eastern Asia: China,796,733,63
E09000010,Enfield,Middle East and Asia: Eastern Asia: Hong Kong (Special Administrative Region of China),610,550,60
E09000010,Enfield,Middle East and Asia: Eastern Asia: Other Eastern Asia,259,234,25
E09000010,Enfield,Middle East and Asia: Middle East: Iran,1710,1607,103
E09000010,Enfield,Middle East and Asia: Middle East: Other Middle East,1867,1714,153
E09000010,Enfield,Middle East and Asia: South-East Asia: Other South-East Asia,1337,1247,90
E09000010,Enfield,Middle East and Asia: South-East Asia: Philippines,1132,1012,120
E09000010,Enfield,Middle East and Asia: Southern Asia: Bangladesh,3537,2849,688
E09000010,Enfield,Middle East and Asia: Southern Asia: India,3730,4186,-456
E09000010,Enfield,Middle East and Asia: Southern Asia: Other Southern Asia,791,679,112
E09000010,Enfield,Middle East and Asia: Southern Asia: Pakistan,1489,1167,322
E09000010,Enfield,Middle East and Asia: Southern Asia: Sri Lanka,2194,2383,-189
E09000010,Enfield,Other,0,0,0
E09000010,Enfield,The Americas and the Caribbean: Central America: All Central American countries,93,54,39
E09000010,Enfield,The Americas and the Caribbean: North America: Other North America,264,273,-9
E09000010,Enfield,The Americas and the Caribbean: North America: United States,622,638,-16
E09000010,Enfield,The Americas and the Caribbean: South America: All South American countries,3144,2001,1143
E09000010,Enfield,The Americas and the Caribbean: The Caribbean: Jamaica,4072,4439,-367
E09000010,Enfield,The Americas and the Caribbean: The Caribbean: Other Caribbean,2505,2678,-173
E09000011,Greenwich,Africa: Africa not otherwise specified,41,150,-109
E09000011,Greenwich,Africa: Central and Western Africa: Ghana,2730,2315,415
E09000011,Greenwich,Africa: Central and Western Africa: Nigeria,14357,13013,1344
E09000011,Greenwich,Africa: Central and Western Africa: Other Central and Western Africa,3606,2852,754
E09000011,Greenwich,Africa: North Africa,1149,789,360
E09000011,Greenwich,Africa: South and Eastern Africa: Kenya,926,1016,-90
E09000011,Greenwich,Africa: South and Eastern Africa: Other South and Eastern Africa,3009,2822,187
E09000011,Greenwich,Africa: South and Eastern Africa: Somalia,2073,1742,331
E09000011,Greenwich,Africa: South and Eastern Africa: South Africa,1465,1356,109
E09000011,Greenwich,Africa: South and Eastern Africa: Zimbabwe,838,962,-124
E09000011,Greenwich,Antarctica and Oceania: Australasia: Australia,1008,894,114
E09000011,Greenwich,Antarctica and Oceania: Australasia: Other Australasia,465,488,-23
E09000011,Greenwich,Antarctica and Oceania: Other Oceania and Antarctica,58,84,-26
E09000011,Greenwich,Europe: Other Europe: EU countries: Countries that joined the EU between April 2001 and March 2011: Lithuania,2744,1979,765
E09000011,Greenwich,Europe: Other Europe: EU countries: Countries that joined the EU between April 2001 and March 2011: Other EU countries,5660,3536,2124
E09000011,Greenwich,Europe: Other Europe: EU countries: Countries that joined the EU between April 2001 and March 2011: Poland,3449,2441,1008
E09000011,Greenwich,Europe: Other Europe: EU countries: Countries that joined the EU between April 2001 and March 2011: Romania,4812,982,3830
E09000011,Greenwich,Europe: Other Europe: EU countries: Member countries in March 2001: France,1959,1286,673
E09000011,Greenwich,Europe: Other Europe: EU countries: Member countries in March 2001: Germany,1520,1417,103
E09000011,Greenwich,Europe: Other Europe: EU countries: Member countries in March 2001: Ireland,2723,3260,-537
E09000011,Greenwich,Europe: Other Europe: EU countries: Member countries in March 2001: Italy,3065,1019,2046
E09000011,Greenwich,Europe: Other Europe: EU countries: Member countries in March 2001: Other member countries in March 2001,3030,1956,1074
E09000011,Greenwich,Europe: Other Europe: EU countries: Member countries in March 2001: Portugal (including Madeira and the Azores),1473,623,850
E09000011,Greenwich,Europe: Other Europe: EU countries: Member countries in March 2001: Spain (including Canary Islands),1711,590,1121
E09000011,Greenwich,Europe: Other Europe: Rest of Europe: Other Europe,5788,2695,3093
E09000011,Greenwich,Europe: Other Europe: Rest of Europe: Turkey,1330,924,406
E09000011,Greenwich,Europe: United Kingdom: England,175656,170208,5448
E09000011,Greenwich,Europe: United Kingdom: Great Britain not otherwise specified,2,18,-16
E09000011,Greenwich,Europe: United Kingdom: Northern Ireland,970,1054,-84
E09000011,Greenwich,Europe: United Kingdom: Scotland,2445,2770,-325
E09000011,Greenwich,Europe: United Kingdom: United Kingdom not otherwise specified,28,61,-33
E09000011,Greenwich,Europe: United Kingdom: Wales,1478,1534,-56
E09000011,Greenwich,Middle East and Asia: Central Asia,257,118,139
E09000011,Greenwich,Middle East and Asia: Eastern Asia: China,2818,1918,900
E09000011,Greenwich,Middle East and Asia: Eastern Asia: Hong Kong (Special Administrative Region of China),1799,1101,698
E09000011,Greenwich,Middle East and Asia: Eastern Asia: Other Eastern Asia,627,444,183
E09000011,Greenwich,Middle East and Asia: Middle East: Iran,314,230,84
E09000011,Greenwich,Middle East and Asia: Middle East: Other Middle East,1283,874,409
E09000011,Greenwich,Middle East and Asia: South-East Asia: Other South-East Asia,3406,2818,588
E09000011,Greenwich,Middle East and Asia: South-East Asia: Philippines,970,548,422
E09000011,Greenwich,Middle East and Asia: Southern Asia: Bangladesh,1051,836,215
E09000011,Greenwich,Middle East and Asia: Southern Asia: India,5746,4367,1379
E09000011,Greenwich,Middle East and Asia: Southern Asia: Other Southern Asia,6566,5291,1275
E09000011,Greenwich,Middle East and Asia: Southern Asia: Pakistan,1601,1289,312
E09000011,Greenwich,Middle East and Asia: Southern Asia: Sri Lanka,1453,1382,71
E09000011,Greenwich,Other,3,1,2
E09000011,Greenwich,The Americas and the Caribbean: Central America: All Central American countries,216,82,134
E09000011,Greenwich,The Americas and the Caribbean: North America: Other North America,638,474,164
E09000011,Greenwich,The Americas and the Caribbean: North America: United States,1779,1175,604
E09000011,Greenwich,The Americas and the Caribbean: South America: All South American countries,3785,1638,2147
E09000011,Greenwich,The Americas and the Caribbean: The Caribbean: Jamaica,2047,2007,40
E09000011,Greenwich,The Americas and the Caribbean: The Caribbean: Other Caribbean,1146,1128,18
E09000012,Hackney,Africa: Africa not otherwise specified,37,163,-126
E09000012,Hackney,Africa: Central and Western Africa: Ghana,3088,3604,-516
E09000012,Hackney,Africa: Central and Western Africa: Nigeria,5239,6692,-1453
E09000012,Hackney,Africa: Central and Western Africa: Other Central and Western Africa,4277,3979,298
E09000012,Hackney,Africa: North Africa,1687,1446,241
E09000012,Hackney,Africa: South and Eastern Africa: Kenya,398,459,-61
E09000012,Hackney,Africa: South and Eastern Africa: Other South and Eastern Africa,2504,2392,112
E09000012,Hackney,Africa: South and Eastern Africa: Somalia,1512,1401,111
E09000012,Hackney,Africa: South and Eastern Africa: South Africa,964,969,-5
E09000012,Hackney,Africa: South and Eastern Africa: Zimbabwe,276,401,-125
E09000012,Hackney,Antarctica and Oceania: Australasia: Australia,3188,2352,836
E09000012,Hackney,Antarctica and Oceania: Australasia: Other Australasia,1257,980,277
E09000012,Hackney,Antarctica and Oceania: Other Oceania and Antarctica,51,45,6
E09000012,Hackney,Europe: Other Europe: EU countries: Countries that joined the EU between April 2001 and March 2011: Lithuania,528,504,24
E09000012,Hackney,Europe: Other Europe: EU countries: Countries that joined the EU between April 2001 and March 2011: Other EU countries,3663,3530,133
E09000012,Hackney,Europe: Other Europe: EU countries: Countries that joined the EU between April 2001 and March 2011: Poland,3529,4203,-674
E09000012,Hackney,Europe: Other Europe: EU countries: Countries that joined the EU between April 2001 and March 2011: Romania,1211,564,647
E09000012,Hackney,Europe: Other Europe: EU countries: Member countries in March 2001: France,3926,2480,1446
E09000012,Hackney,Europe: Other Europe: EU countries: Member countries in March 2001: Germany,2230,2285,-55
E09000012,Hackney,Europe: Other Europe: EU countries: Member countries in March 2001: Ireland,3311,3977,-666
E09000012,Hackney,Europe: Other Europe: EU countries: Member countries in March 2001: Italy,4378,2360,2018
E09000012,Hackney,Europe: Other Europe: EU countries: Member countries in March 2001: Other member countries in March 2001,4630,3502,1128
E09000012,Hackney,Europe: Other Europe: EU countries: Member countries in March 2001: Portugal (including Madeira and the Azores),1813,1160,653
E09000012,Hackney,Europe: Other Europe: EU countries: Member countries in March 2001: Spain (including Canary Islands),2876,1659,1217
E09000012,Hackney,Europe: Other Europe: Rest of Europe: Other Europe,3401,2774,627
E09000012,Hackney,Europe: Other Europe: Rest of Europe: Turkey,8674,8982,-308
E09000012,Hackney,Europe: United Kingdom: England,150832,143932,6900
E09000012,Hackney,Europe: United Kingdom: Great Britain not otherwise specified,6,25,-19
E09000012,Hackney,Europe: United Kingdom: Northern Ireland,1102,1185,-83
E09000012,Hackney,Europe: United Kingdom: Scotland,2827,3132,-305
E09000012,Hackney,Europe: United Kingdom: United Kingdom not otherwise specified,16,59,-43
E09000012,Hackney,Europe: United Kingdom: Wales,1436,1697,-261
E09000012,Hackney,Middle East and Asia: Central Asia,137,148,-11
E09000012,Hackney,Middle East and Asia: Eastern Asia: China,1218,1003,215
E09000012,Hackney,Middle East and Asia: Eastern Asia: Hong Kong (Special Administrative Region of China),688,551,137
E09000012,Hackney,Middle East and Asia: Eastern Asia: Other Eastern Asia,867,1085,-218
E09000012,Hackney,Middle East and Asia: Middle East: Iran,381,398,-17
E09000012,Hackney,Middle East and Asia: Middle East: Other Middle East,3606,2784,822
E09000012,Hackney,Middle East and Asia: South-East Asia: Other South-East Asia,2350,2632,-282
E09000012,Hackney,Middle East and Asia: South-East Asia: Philippines,626,582,44
E09000012,Hackney,Middle East and Asia: Southern Asia: Bangladesh,2511,2659,-148
E09000012,Hackney,Middle East and Asia: Southern Asia: India,3126,2955,171
E09000012,Hackney,Middle East and Asia: Southern Asia: Other Southern Asia,360,362,-2
E09000012,Hackney,Middle East and Asia: Southern Asia: Pakistan,1020,840,180
E09000012,Hackney,Middle East and Asia: Southern Asia: Sri Lanka,159,171,-12
E09000012,Hackney,Other,2,1,1
E09000012,Hackney,The Americas and the Caribbean: Central America: All Central American countries,356,233,123
E09000012,Hackney,The Americas and the Caribbean: North America: Other North America,1335,990,345
E09000012,Hackney,The Americas and the Caribbean: North America: United States,3735,2747,988
E09000012,Hackney,The Americas and the Caribbean: South America: All South American countries,5376,4221,1155
E09000012,Hackney,The Americas and the Caribbean: The Caribbean: Jamaica,3250,4444,-1194
E09000012,Hackney,The Americas and the Caribbean: The Caribbean: Other Caribbean,3177,4571,-1394
E09000013,Hammersmith and Fulham,Africa: Africa not otherwise specified,30,56,-26
E09000013,Hammersmith and Fulham,Africa: Central and Western Africa: Ghana,702,724,-22
E09000013,Hammersmith and Fulham,Africa: Central and Western Africa: Nigeria,934,941,-7
E09000013,Hammersmith and Fulham,Africa: Central and Western Africa: Other Central and Western Africa,808,737,71
E09000013,Hammersmith and Fulham,Africa: North Africa,2869,2425,444
E09000013,Hammersmith and Fulham,Africa: South and Eastern Africa: Kenya,407,443,-36
E09000013,Hammersmith and Fulham,Africa: South and Eastern Africa: Other South and Eastern Africa,2614,2541,73
E09000013,Hammersmith and Fulham,Africa: South and Eastern Africa: Somalia,2446,2701,-255
E09000013,Hammersmith and Fulham,Africa: South and Eastern Africa: South Africa,1564,1748,-184
E09000013,Hammersmith and Fulham,Africa: South and Eastern Africa: Zimbabwe,282,354,-72
E09000013,Hammersmith and Fulham,Antarctica and Oceania: Australasia: Australia,2318,4601,-2283
E09000013,Hammersmith and Fulham,Antarctica and Oceania: Australasia: Other Australasia,879,2355,-1476
E09000013,Hammersmith and Fulham,Antarctica and Oceania: Other Oceania and Antarctica,57,68,-11
E09000013,Hammersmith and Fulham,Europe: Other Europe: EU countries: Countries that joined the EU between April 2001 and March 2011: Lithuania,537,368,169
E09000013,Hammersmith and Fulham,Europe: Other Europe: EU countries: Countries that joined the EU between April 2001 and March 2011: Other EU countries,2681,2110,571
E09000013,Hammersmith and Fulham,Europe: Other Europe: EU countries: Countries that joined the EU between April 2001 and March 2011: Poland,2553,3111,-558
E09000013,Hammersmith and Fulham,Europe: Other Europe: EU countries: Countries that joined the EU between April 2001 and March 2011: Romania,1186,434,752
E09000013,Hammersmith and Fulham,Europe: Other Europe: EU countries: Member countries in March 2001: France,5094,4977,117
E09000013,Hammersmith and Fulham,Europe: Other Europe: EU countries: Member countries in March 2001: Germany,1675,1796,-121
E09000013,Hammersmith and Fulham,Europe: Other Europe: EU countries: Member countries in March 2001: Ireland,3036,4874,-1838
E09000013,Hammersmith and Fulham,Europe: Other Europe: EU countries: Member countries in March 2001: Italy,5408,2827,2581
E09000013,Hammersmith and Fulham,Europe: Other Europe: EU countries: Member countries in March 2001: Other member countries in March 2001,3920,3327,593
E09000013,Hammersmith and Fulham,Europe: Other Europe: EU countries: Member countries in March 2001: Portugal (including Madeira and the Azores),1568,1324,244
E09000013,Hammersmith and Fulham,Europe: Other Europe: EU countries: Member countries in March 2001: Spain (including Canary Islands),3258,1853,1405
E09000013,Hammersmith and Fulham,Europe: Other Europe: Rest of Europe: Other Europe,5239,3677,1562
E09000013,Hammersmith and Fulham,Europe: Other Europe: Rest of Europe: Turkey,907,643,264
E09000013,Hammersmith and Fulham,Europe: United Kingdom: England,95299,98491,-3192
E09000013,Hammersmith and Fulham,Europe: United Kingdom: Great Britain not otherwise specified,4,6,-2
E09000013,Hammersmith and Fulham,Europe: United Kingdom: Northern Ireland,844,1168,-324
E09000013,Hammersmith and Fulham,Europe: United Kingdom: Scotland,2441,3128,-687
E09000013,Hammersmith and Fulham,Europe: United Kingdom: United Kingdom not otherwise specified,9,35,-26
E09000013,Hammersmith and Fulham,Europe: United Kingdom: Wales,1219,1626,-407
E09000013,Hammersmith and Fulham,Middle East and Asia: Central Asia,180,201,-21
E09000013,Hammersmith and Fulham,Middle East and Asia: Eastern Asia: China,2038,1027,1011
E09000013,Hammersmith and Fulham,Middle East and Asia: Eastern Asia: Hong Kong (Special Administrative Region of China),1055,778,277
E09000013,Hammersmith and Fulham,Middle East and Asia: Eastern Asia: Other Eastern Asia,1269,1172,97
E09000013,Hammersmith and Fulham,Middle East and Asia: Middle East: Iran,1635,1606,29
E09000013,Hammersmith and Fulham,Middle East and Asia: Middle East: Other Middle East,3434,3147,287
E09000013,Hammersmith and Fulham,Middle East and Asia: South-East Asia: Other South-East Asia,1936,2121,-185
E09000013,Hammersmith and Fulham,Middle East and Asia: South-East Asia: Philippines,2943,2192,751
E09000013,Hammersmith and Fulham,Middle East and Asia: Southern Asia: Bangladesh,551,500,51
E09000013,Hammersmith and Fulham,Middle East and Asia: Southern Asia: India,1994,1657,337
E09000013,Hammersmith and Fulham,Middle East and Asia: Southern Asia: Other Southern Asia,729,773,-44
E09000013,Hammersmith and Fulham,Middle East and Asia: Southern Asia: Pakistan,913,788,125
E09000013,Hammersmith and Fulham,Middle East and Asia: Southern Asia: Sri Lanka,254,308,-54
E09000013,Hammersmith and Fulham,Other,0,0,0
E09000013,Hammersmith and Fulham,The Americas and the Caribbean: Central America: All Central American countries,354,308,46
E09000013,Hammersmith and Fulham,The Americas and the Caribbean: North America: Other North America,989,1099,-110
E09000013,Hammersmith and Fulham,The Americas and the Caribbean: North America: United States,3422,2906,516
E09000013,Hammersmith and Fulham,The Americas and the Caribbean: South America: All South American countries,4289,3367,922
E09000013,Hammersmith and Fulham,The Americas and the Caribbean: The Caribbean: Jamaica,850,1144,-294
E09000013,Hammersmith and Fulham,The Americas and the Caribbean: The Caribbean: Other Caribbean,1526,1930,-404
E09000014,Haringey,Africa: Africa not otherwise specified,47,135,-88
E09000014,Haringey,Africa: Central and Western Africa: Ghana,3153,3500,-347
E09000014,Haringey,Africa: Central and Western Africa: Nigeria,2380,2760,-380
E09000014,Haringey,Africa: Central and Western Africa: Other Central and Western Africa,3029,2697,332
E09000014,Haringey,Africa: North Africa,1827,1728,99
E09000014,Haringey,Africa: South and Eastern Africa: Kenya,792,867,-75
E09000014,Haringey,Africa: South and Eastern Africa: Other South and Eastern Africa,4233,4625,-392
E09000014,Haringey,Africa: South and Eastern Africa: Somalia,2642,3325,-683
E09000014,Haringey,Africa: South and Eastern Africa: South Africa,1214,1553,-339
E09000014,Haringey,Africa: South and Eastern Africa: Zimbabwe,395,437,-42
E09000014,Haringey,Antarctica and Oceania: Australasia: Australia,1407,1746,-339
E09000014,Haringey,Antarctica and Oceania: Australasia: Other Australasia,558,792,-234
E09000014,Haringey,Antarctica and Oceania: Other Oceania and Antarctica,47,35,12
E09000014,Haringey,Europe: Other Europe: EU countries: Countries that joined the EU between April 2001 and March 2011: Lithuania,919,955,-36
E09000014,Haringey,Europe: Other Europe: EU countries: Countries that joined the EU between April 2001 and March 2011: Other EU countries,12087,10713,1374
E09000014,Haringey,Europe: Other Europe: EU countries: Countries that joined the EU between April 2001 and March 2011: Poland,7212,10865,-3653
E09000014,Haringey,Europe: Other Europe: EU countries: Countries that joined the EU between April 2001 and March 2011: Romania,6353,2374,3979
E09000014,Haringey,Europe: Other Europe: EU countries: Member countries in March 2001: France,2157,1931,226
E09000014,Haringey,Europe: Other Europe: EU countries: Member countries in March 2001: Germany,1535,1884,-349
E09000014,Haringey,Europe: Other Europe: EU countries: Member countries in March 2001: Ireland,3312,4820,-1508
E09000014,Haringey,Europe: Other Europe: EU countries: Member countries in March 2001: Italy,5279,2920,2359
E09000014,Haringey,Europe: Other Europe: EU countries: Member countries in March 2001: Other member countries in March 2001,4469,3223,1246
E09000014,Haringey,Europe: Other Europe: EU countries: Member countries in March 2001: Portugal (including Madeira and the Azores),1676,1504,172
E09000014,Haringey,Europe: Other Europe: EU countries: Member countries in March 2001: Spain (including Canary Islands),3357,1703,1654
E09000014,Haringey,Europe: Other Europe: Rest of Europe: Other Europe,7089,4375,2714
E09000014,Haringey,Europe: Other Europe: Rest of Europe: Turkey,9465,10096,-631
E09000014,Haringey,Europe: United Kingdom: England,137952,134982,2970
E09000014,Haringey,Europe: United Kingdom: Great Britain not otherwise specified,1,30,-29
E09000014,Haringey,Europe: United Kingdom: Northern Ireland,973,1213,-240
E09000014,Haringey,Europe: United Kingdom: Scotland,2585,3054,-469
E09000014,Haringey,Europe: United Kingdom: United Kingdom not otherwise specified,23,77,-54
E09000014,Haringey,Europe: United Kingdom: Wales,1583,1872,-289
E09000014,Haringey,Middle East and Asia: Central Asia,185,253,-68
E09000014,Haringey,Middle East and Asia: Eastern Asia: China,1451,1490,-39
E09000014,Haringey,Middle East and Asia: Eastern Asia: Hong Kong (Special Administrative Region of China),832,666,166
E09000014,Haringey,Middle East and Asia: Eastern Asia: Other Eastern Asia,724,858,-134
E09000014,Haringey,Middle East and Asia: Middle East: Iran,980,957,23
E09000014,Haringey,Middle East and Asia: Middle East: Other Middle East,2266,2321,-55
E09000014,Haringey,Middle East and Asia: South-East Asia: Other South-East Asia,1745,1873,-128
E09000014,Haringey,Middle East and Asia: South-East Asia: Philippines,1073,1105,-32
E09000014,Haringey,Middle East and Asia: Southern Asia: Bangladesh,2153,2264,-111
E09000014,Haringey,Middle East and Asia: Southern Asia: India,2135,2531,-396
E09000014,Haringey,Middle East and Asia: Southern Asia: Other Southern Asia,412,469,-57
E09000014,Haringey,Middle East and Asia: Southern Asia: Pakistan,980,926,54
E09000014,Haringey,Middle East and Asia: Southern Asia: Sri Lanka,478,587,-109
E09000014,Haringey,Other,0,0,0
E09000014,Haringey,The Americas and the Caribbean: Central America: All Central American countries,315,221,94
E09000014,Haringey,The Americas and the Caribbean: North America: Other North America,801,837,-36
E09000014,Haringey,The Americas and the Caribbean: North America: United States,2238,1984,254
E09000014,Haringey,The Americas and the Caribbean: South America: All South American countries,8730,4695,4035
E09000014,Haringey,The Americas and the Caribbean: The Caribbean: Jamaica,3799,5165,-1366
E09000014,Haringey,The Americas and the Caribbean: The Caribbean: Other Caribbean,3188,2933,255
E09000015,Harrow,Africa: Africa not otherwise specified,185,527,-342
E09000015,Harrow,Africa: Central and Western Africa: Ghana,915,866,49
E09000015,Harrow,Africa: Central and Western Africa: Nigeria,1199,1154,45
E09000015,Harrow,Africa: Central and Western Africa: Other Central and Western Africa,635,619,16
E09000015,Harrow,Africa: North Africa,1375,1030,345
E09000015,Harrow,Africa: South and Eastern Africa: Kenya,10859,11706,-847
E09000015,Harrow,Africa: South and Eastern Africa: Other South and Eastern Africa,8058,8219,-161
E09000015,Harrow,Africa: South and Eastern Africa: Somalia,2455,2241,214
E09000015,Harrow,Africa: South and Eastern Africa: South Africa,766,1074,-308
E09000015,Harrow,Africa: South and Eastern Africa: Zimbabwe,319,462,-143
E09000015,Harrow,Antarctica and Oceania: Australasia: Australia,287,358,-71
E09000015,Harrow,Antarctica and Oceania: Australasia: Other Australasia,136,231,-95
E09000015,Harrow,Antarctica and Oceania: Other Oceania and Antarctica,172,144,28
E09000015,Harrow,Europe: Other Europe: EU countries: Countries that joined the EU between April 2001 and March 2011: Lithuania,462,550,-88
E09000015,Harrow,Europe: Other Europe: EU countries: Countries that joined the EU between April 2001 and March 2011: Other EU countries,2466,2063,403
E09000015,Harrow,Europe: Other Europe: EU countries: Countries that joined the EU between April 2001 and March 2011: Poland,3602,3868,-266
E09000015,Harrow,Europe: Other Europe: EU countries: Countries that joined the EU between April 2001 and March 2011: Romania,21082,4784,16298
E09000015,Harrow,Europe: Other Europe: EU countries: Member countries in March 2001: France,1043,1142,-99
E09000015,Harrow,Europe: Other Europe: EU countries: Member countries in March 2001: Germany,1165,1446,-281
E09000015,Harrow,Europe: Other Europe: EU countries: Member countries in March 2001: Ireland,3245,4953,-1708
E09000015,Harrow,Europe: Other Europe: EU countries: Member countries in March 2001: Italy,1453,678,775
E09000015,Harrow,Europe: Other Europe: EU countries: Member countries in March 2001: Other member countries in March 2001,2062,1736,326
E09000015,Harrow,Europe: Other Europe: EU countries: Member countries in March 2001: Portugal (including Madeira and the Azores),774,762,12
E09000015,Harrow,Europe: Other Europe: EU countries: Member countries in March 2001: Spain (including Canary Islands),718,412,306
E09000015,Harrow,Europe: Other Europe: Rest of Europe: Other Europe,3115,1827,1288
E09000015,Harrow,Europe: Other Europe: Rest of Europe: Turkey,485,385,100
E09000015,Harrow,Europe: United Kingdom: England,125093,128424,-3331
E09000015,Harrow,Europe: United Kingdom: Great Britain not otherwise specified,7,11,-4
E09000015,Harrow,Europe: United Kingdom: Northern Ireland,469,680,-211
E09000015,Harrow,Europe: United Kingdom: Scotland,1191,1591,-400
E09000015,Harrow,Europe: United Kingdom: United Kingdom not otherwise specified,14,81,-67
E09000015,Harrow,Europe: United Kingdom: Wales,836,1220,-384
E09000015,Harrow,Middle East and Asia: Central Asia,59,30,29
E09000015,Harrow,Middle East and Asia: Eastern Asia: China,792,606,186
E09000015,Harrow,Middle East and Asia: Eastern Asia: Hong Kong (Special Administrative Region of China),820,758,62
E09000015,Harrow,Middle East and Asia: Eastern Asia: Other Eastern Asia,430,468,-38
E09000015,Harrow,Middle East and Asia: Middle East: Iran,1331,1198,133
E09000015,Harrow,Middle East and Asia: Middle East: Other Middle East,4809,3184,1625
E09000015,Harrow,Middle East and Asia: South-East Asia: Other South-East Asia,1314,1266,48
E09000015,Harrow,Middle East and Asia: South-East Asia: Philippines,1172,789,383
E09000015,Harrow,Middle East and Asia: Southern Asia: Bangladesh,812,700,112
E09000015,Harrow,Middle East and Asia: Southern Asia: India,26376,21539,4837
E09000015,Harrow,Middle East and Asia: Southern Asia: Other Southern Asia,6411,4611,1800
E09000015,Harrow,Middle East and Asia: Southern Asia: Pakistan,4485,3582,903
E09000015,Harrow,Middle East and Asia: Southern Asia: Sri Lanka,10706,10392,314
E09000015,Harrow,Other,2,2,0
E09000015,Harrow,The Americas and the Caribbean: Central America: All Central American countries,52,52,0
E09000015,Harrow,The Americas and the Caribbean: North America: Other North America,247,245,2
E09000015,Harrow,The Americas and the Caribbean: North America: United States,735,683,52
E09000015,Harrow,The Americas and the Caribbean: South America: All South American countries,1507,937,570
E09000015,Harrow,The Americas and the Caribbean: The Caribbean: Jamaica,1505,1691,-186
E09000015,Harrow,The Americas and the Caribbean: The Caribbean: Other Caribbean,993,1079,-86
E09000016,Havering,Africa: Africa not otherwise specified,22,58,-36
E09000016,Havering,Africa: Central and Western Africa: Ghana,1246,678,568
E09000016,Havering,Africa: Central and Western Africa: Nigeria,4137,2241,1896
E09000016,Havering,Africa: Central and Western Africa: Other Central and Western Africa,855,430,425
E09000016,Havering,Africa: North Africa,507,286,221
E09000016,Havering,Africa: South and Eastern Africa: Kenya,662,462,200
E09000016,Havering,Africa: South and Eastern Africa: Other South and Eastern Africa,1399,869,530
E09000016,Havering,Africa: South and Eastern Africa: Somalia,161,39,122
E09000016,Havering,Africa: South and Eastern Africa: South Africa,681,621,60
E09000016,Havering,Africa: South and Eastern Africa: Zimbabwe,710,647,63
E09000016,Havering,Antarctica and Oceania: Australasia: Australia,241,213,28
E09000016,Havering,Antarctica and Oceania: Australasia: Other Australasia,109,137,-28
E09000016,Havering,Antarctica and Oceania: Other Oceania and Antarctica,29,13,16
E09000016,Havering,Europe: Other Europe: EU countries: Countries that joined the EU between April 2001 and March 2011: Lithuania,2841,1065,1776
E09000016,Havering,Europe: Other Europe: EU countries: Countries that joined the EU between April 2001 and March 2011: Other EU countries,2686,1201,1485
E09000016,Havering,Europe: Other Europe: EU countries: Countries that joined the EU between April 2001 and March 2011: Poland,1868,925,943
E09000016,Havering,Europe: Other Europe: EU countries: Countries that joined the EU between April 2001 and March 2011: Romania,5393,459,4934
E09000016,Havering,Europe: Other Europe: EU countries: Member countries in March 2001: France,363,215,148
E09000016,Havering,Europe: Other Europe: EU countries: Member countries in March 2001: Germany,495,488,7
E09000016,Havering,Europe: Other Europe: EU countries: Member countries in March 2001: Ireland,2082,2503,-421
E09000016,Havering,Europe: Other Europe: EU countries: Member countries in March 2001: Italy,752,298,454
E09000016,Havering,Europe: Other Europe: EU countries: Member countries in March 2001: Other member countries in March 2001,678,435,243
E09000016,Havering,Europe: Other Europe: EU countries: Member countries in March 2001: Portugal (including Madeira and the Azores),488,203,285
E09000016,Havering,Europe: Other Europe: EU countries: Member countries in March 2001: Spain (including Canary Islands),485,233,252
E09000016,Havering,Europe: Other Europe: Rest of Europe: Other Europe,4303,898,3405
E09000016,Havering,Europe: Other Europe: Rest of Europe: Turkey,588,323,265
E09000016,Havering,Europe: United Kingdom: England,208603,209666,-1063
E09000016,Havering,Europe: United Kingdom: Great Britain not otherwise specified,2,6,-4
E09000016,Havering,Europe: United Kingdom: Northern Ireland,443,524,-81
E09000016,Havering,Europe: United Kingdom: Scotland,1284,1575,-291
E09000016,Havering,Europe: United Kingdom: United Kingdom not otherwise specified,5,18,-13
E09000016,Havering,Europe: United Kingdom: Wales,830,1051,-221
E09000016,Havering,Middle East and Asia: Central Asia,72,19,53
E09000016,Havering,Middle East and Asia: Eastern Asia: China,592,330,262
E09000016,Havering,Middle East and Asia: Eastern Asia: Hong Kong (Special Administrative Region of China),460,365,95
E09000016,Havering,Middle East and Asia: Eastern Asia: Other Eastern Asia,148,94,54
E09000016,Havering,Middle East and Asia: Middle East: Iran,229,153,76
E09000016,Havering,Middle East and Asia: Middle East: Other Middle East,587,268,319
E09000016,Havering,Middle East and Asia: South-East Asia: Other South-East Asia,896,645,251
E09000016,Havering,Middle East and Asia: South-East Asia: Philippines,1138,759,379
E09000016,Havering,Middle East and Asia: Southern Asia: Bangladesh,1910,512,1398
E09000016,Havering,Middle East and Asia: Southern Asia: India,4603,2301,2302
E09000016,Havering,Middle East and Asia: Southern Asia: Other Southern Asia,330,90,240
E09000016,Havering,Middle East and Asia: Southern Asia: Pakistan,2505,653,1852
E09000016,Havering,Middle East and Asia: Southern Asia: Sri Lanka,764,413,351
E09000016,Havering,Other,0,0,0
E09000016,Havering,The Americas and the Caribbean: Central America: All Central American countries,45,20,25
E09000016,Havering,The Americas and the Caribbean: North America: Other North America,170,169,1
E09000016,Havering,The Americas and the Caribbean: North America: United States,363,288,75
E09000016,Havering,The Americas and the Caribbean: South America: All South American countries,789,333,456
E09000016,Havering,The Americas and the Caribbean: The Caribbean: Jamaica,671,415,256
E09000016,Havering,The Americas and the Caribbean: The Caribbean: Other Caribbean,838,625,213
E09000017,Hillingdon,Africa: Africa not otherwise specified,76,322,-246
E09000017,Hillingdon,Africa: Central and Western Africa: Ghana,736,568,168
E09000017,Hillingdon,Africa: Central and Western Africa: Nigeria,1514,1350,164
E09000017,Hillingdon,Africa: Central and Western Africa: Other Central and Western Africa,961,758,203
E09000017,Hillingdon,Africa: North Africa,1680,1165,515
E09000017,Hillingdon,Africa: South and Eastern Africa: Kenya,3670,3612,58
E09000017,Hillingdon,Africa: South and Eastern Africa: Other South and Eastern Africa,5040,4398,642
E09000017,Hillingdon,Africa: South and Eastern Africa: Somalia,3281,3130,151
E09000017,Hillingdon,Africa: South and Eastern Africa: South Africa,940,1074,-134
E09000017,Hillingdon,Africa: South and Eastern Africa: Zimbabwe,639,849,-210
E09000017,Hillingdon,Antarctica and Oceania: Australasia: Australia,347,372,-25
E09000017,Hillingdon,Antarctica and Oceania: Australasia: Other Australasia,219,299,-80
E09000017,Hillingdon,Antarctica and Oceania: Other Oceania and Antarctica,163,129,34
E09000017,Hillingdon,Europe: Other Europe: EU countries: Countries that joined the EU between April 2001 and March 2011: Lithuania,1138,921,217
E09000017,Hillingdon,Europe: Other Europe: EU countries: Countries that joined the EU between April 2001 and March 2011: Other EU countries,2825,1936,889
E09000017,Hillingdon,Europe: Other Europe: EU countries: Countries that joined the EU between April 2001 and March 2011: Poland,6398,4243,2155
E09000017,Hillingdon,Europe: Other Europe: EU countries: Countries that joined the EU between April 2001 and March 2011: Romania,5575,850,4725
E09000017,Hillingdon,Europe: Other Europe: EU countries: Member countries in March 2001: France,842,673,169
E09000017,Hillingdon,Europe: Other Europe: EU countries: Member countries in March 2001: Germany,1183,1368,-185
E09000017,Hillingdon,Europe: Other Europe: EU countries: Member countries in March 2001: Ireland,3511,4324,-813
E09000017,Hillingdon,Europe: Other Europe: EU countries: Member countries in March 2001: Italy,1934,746,1188
E09000017,Hillingdon,Europe: Other Europe: EU countries: Member countries in March 2001: Other member countries in March 2001,2201,1831,370
E09000017,Hillingdon,Europe: Other Europe: EU countries: Member countries in March 2001: Portugal (including Madeira and the Azores),1807,1084,723
E09000017,Hillingdon,Europe: Other Europe: EU countries: Member countries in March 2001: Spain (including Canary Islands),857,500,357
E09000017,Hillingdon,Europe: Other Europe: Rest of Europe: Other Europe,4056,1839,2217
E09000017,Hillingdon,Europe: Other Europe: Rest of Europe: Turkey,595,403,192
E09000017,Hillingdon,Europe: United Kingdom: England,184323,186308,-1985
E09000017,Hillingdon,Europe: United Kingdom: Great Britain not otherwise specified,3,5,-2
E09000017,Hillingdon,Europe: United Kingdom: Northern Ireland,716,992,-276
E09000017,Hillingdon,Europe: United Kingdom: Scotland,1853,2570,-717
E09000017,Hillingdon,Europe: United Kingdom: United Kingdom not otherwise specified,22,74,-52
E09000017,Hillingdon,Europe: United Kingdom: Wales,1343,1910,-567
E09000017,Hillingdon,Middle East and Asia: Central Asia,117,45,72
E09000017,Hillingdon,Middle East and Asia: Eastern Asia: China,1125,1062,63
E09000017,Hillingdon,Middle East and Asia: Eastern Asia: Hong Kong (Special Administrative Region of China),1142,859,283
E09000017,Hillingdon,Middle East and Asia: Eastern Asia: Other Eastern Asia,394,460,-66
E09000017,Hillingdon,Middle East and Asia: Middle East: Iran,1126,910,216
E09000017,Hillingdon,Middle East and Asia: Middle East: Other Middle East,3484,2189,1295
E09000017,Hillingdon,Middle East and Asia: South-East Asia: Other South-East Asia,1802,1851,-49
E09000017,Hillingdon,Middle East and Asia: South-East Asia: Philippines,1515,1142,373
E09000017,Hillingdon,Middle East and Asia: Southern Asia: Bangladesh,1927,1352,575
E09000017,Hillingdon,Middle East and Asia: Southern Asia: India,27738,15617,12121
E09000017,Hillingdon,Middle East and Asia: Southern Asia: Other Southern Asia,8494,4737,3757
E09000017,Hillingdon,Middle East and Asia: Southern Asia: Pakistan,6466,4825,1641
E09000017,Hillingdon,Middle East and Asia: Southern Asia: Sri Lanka,5106,4290,816
E09000017,Hillingdon,Other,1,2,-1
E09000017,Hillingdon,The Americas and the Caribbean: Central America: All Central American countries,101,88,13
E09000017,Hillingdon,The Americas and the Caribbean: North America: Other North America,335,339,-4
E09000017,Hillingdon,The Americas and the Caribbean: North America: United States,909,775,134
E09000017,Hillingdon,The Americas and the Caribbean: South America: All South American countries,1572,873,699
E09000017,Hillingdon,The Americas and the Caribbean: The Caribbean: Jamaica,904,802,102
E09000017,Hillingdon,The Americas and the Caribbean: The Caribbean: Other Caribbean,1206,1115,91
E09000018,Hounslow,Africa: Africa not otherwise specified,99,383,-284
E09000018,Hounslow,Africa: Central and Western Africa: Ghana,1197,1148,49
E09000018,Hounslow,Africa: Central and Western Africa: Nigeria,1205,1041,164
E09000018,Hounslow,Africa: Central and Western Africa: Other Central and Western Africa,1055,831,224
E09000018,Hounslow,Africa: North Africa,3081,2014,1067
E09000018,Hounslow,Africa: South and Eastern Africa: Kenya,3755,4480,-725
E09000018,Hounslow,Africa: South and Eastern Africa: Other South and Eastern Africa,4084,4259,-175
E09000018,Hounslow,Africa: South and Eastern Africa: Somalia,3032,2707,325
E09000018,Hounslow,Africa: South and Eastern Africa: South Africa,1123,1325,-202
E09000018,Hounslow,Africa: South and Eastern Africa: Zimbabwe,569,705,-136
E09000018,Hounslow,Antarctica and Oceania: Australasia: Australia,821,1049,-228
E09000018,Hounslow,Antarctica and Oceania: Australasia: Other Australasia,429,772,-343
E09000018,Hounslow,Antarctica and Oceania: Other Oceania and Antarctica,167,115,52
E09000018,Hounslow,Europe: Other Europe: EU countries: Countries that joined the EU between April 2001 and March 2011: Lithuania,1556,1143,413
E09000018,Hounslow,Europe: Other Europe: EU countries: Countries that joined the EU between April 2001 and March 2011: Other EU countries,4411,2934,1477
E09000018,Hounslow,Europe: Other Europe: EU countries: Countries that joined the EU between April 2001 and March 2011: Poland,11105,10355,750
E09000018,Hounslow,Europe: Other Europe: EU countries: Countries that joined the EU between April 2001 and March 2011: Romania,5443,829,4614
E09000018,Hounslow,Europe: Other Europe: EU countries: Member countries in March 2001: France,1391,1211,180
E09000018,Hounslow,Europe: Other Europe: EU countries: Member countries in March 2001: Germany,1061,1186,-125
E09000018,Hounslow,Europe: Other Europe: EU countries: Member countries in March 2001: Ireland,2593,3643,-1050
E09000018,Hounslow,Europe: Other Europe: EU countries: Member countries in March 2001: Italy,2507,1093,1414
E09000018,Hounslow,Europe: Other Europe: EU countries: Member countries in March 2001: Other member countries in March 2001,2398,1701,697
E09000018,Hounslow,Europe: Other Europe: EU countries: Member countries in March 2001: Portugal (including Madeira and the Azores),2031,1395,636
E09000018,Hounslow,Europe: Other Europe: EU countries: Member countries in March 2001: Spain (including Canary Islands),1400,786,614
E09000018,Hounslow,Europe: Other Europe: Rest of Europe: Other Europe,6349,2612,3737
E09000018,Hounslow,Europe: Other Europe: Rest of Europe: Turkey,769,413,356
E09000018,Hounslow,Europe: United Kingdom: England,141720,139124,2596
E09000018,Hounslow,Europe: United Kingdom: Great Britain not otherwise specified,5,10,-5
E09000018,Hounslow,Europe: United Kingdom: Northern Ireland,744,888,-144
E09000018,Hounslow,Europe: United Kingdom: Scotland,1961,2410,-449
E09000018,Hounslow,Europe: United Kingdom: United Kingdom not otherwise specified,26,80,-54
E09000018,Hounslow,Europe: United Kingdom: Wales,1099,1532,-433
E09000018,Hounslow,Middle East and Asia: Central Asia,174,110,64
E09000018,Hounslow,Middle East and Asia: Eastern Asia: China,948,665,283
E09000018,Hounslow,Middle East and Asia: Eastern Asia: Hong Kong (Special Administrative Region of China),1073,932,141
E09000018,Hounslow,Middle East and Asia: Eastern Asia: Other Eastern Asia,622,533,89
E09000018,Hounslow,Middle East and Asia: Middle East: Iran,1491,1070,421
E09000018,Hounslow,Middle East and Asia: Middle East: Other Middle East,4079,2733,1346
E09000018,Hounslow,Middle East and Asia: South-East Asia: Other South-East Asia,2376,2348,28
E09000018,Hounslow,Middle East and Asia: South-East Asia: Philippines,2365,2027,338
E09000018,Hounslow,Middle East and Asia: Southern Asia: Bangladesh,1380,1137,243
E09000018,Hounslow,Middle East and Asia: Southern Asia: India,38028,27288,10740
E09000018,Hounslow,Middle East and Asia: Southern Asia: Other Southern Asia,9887,6558,3329
E09000018,Hounslow,Middle East and Asia: Southern Asia: Pakistan,8255,7051,1204
E09000018,Hounslow,Middle East and Asia: Southern Asia: Sri Lanka,2392,2660,-268
E09000018,Hounslow,Other,0,0,0
E09000018,Hounslow,The Americas and the Caribbean: Central America: All Central American countries,165,95,70
E09000018,Hounslow,The Americas and the Caribbean: North America: Other North America,410,416,-6
E09000018,Hounslow,The Americas and the Caribbean: North America: United States,1383,1192,191
E09000018,Hounslow,The Americas and the Caribbean: South America: All South American countries,2449,1433,1016
E09000018,Hounslow,The Americas and the Caribbean: The Caribbean: Jamaica,654,677,-23
E09000018,Hounslow,The Americas and the Caribbean: The Caribbean: Other Caribbean,860,858,2
E09000019,Islington,Africa: Africa not otherwise specified,29,58,-29
E09000019,Islington,Africa: Central and Western Africa: Ghana,850,826,24
E09000019,Islington,Africa: Central and Western Africa: Nigeria,1477,1547,-70
E09000019,Islington,Africa: Central and Western Africa: Other Central and Western Africa,1502,1279,223
E09000019,Islington,Africa: North Africa,1940,1484,456
E09000019,Islington,Africa: South and Eastern Africa: Kenya,370,456,-86
E09000019,Islington,Africa: South and Eastern Africa: Other South and Eastern Africa,3200,2813,387
E09000019,Islington,Africa: South and Eastern Africa: Somalia,3070,2518,552
E09000019,Islington,Africa: South and Eastern Africa: South Africa,1065,1115,-50
E09000019,Islington,Africa: South and Eastern Africa: Zimbabwe,295,283,12
E09000019,Islington,Antarctica and Oceania: Australasia: Australia,3225,3029,196
E09000019,Islington,Antarctica and Oceania: Australasia: Other Australasia,1164,1174,-10
E09000019,Islington,Antarctica and Oceania: Other Oceania and Antarctica,50,48,2
E09000019,Islington,Europe: Other Europe: EU countries: Countries that joined the EU between April 2001 and March 2011: Lithuania,469,245,224
E09000019,Islington,Europe: Other Europe: EU countries: Countries that joined the EU between April 2001 and March 2011: Other EU countries,3497,3458,39
E09000019,Islington,Europe: Other Europe: EU countries: Countries that joined the EU between April 2001 and March 2011: Poland,1806,1749,57
E09000019,Islington,Europe: Other Europe: EU countries: Countries that joined the EU between April 2001 and March 2011: Romania,1244,343,901
E09000019,Islington,Europe: Other Europe: EU countries: Member countries in March 2001: France,4346,2658,1688
E09000019,Islington,Europe: Other Europe: EU countries: Member countries in March 2001: Germany,1958,2090,-132
E09000019,Islington,Europe: Other Europe: EU countries: Member countries in March 2001: Ireland,4116,5679,-1563
E09000019,Islington,Europe: Other Europe: EU countries: Member countries in March 2001: Italy,5079,2956,2123
E09000019,Islington,Europe: Other Europe: EU countries: Member countries in March 2001: Other member countries in March 2001,4457,3294,1163
E09000019,Islington,Europe: Other Europe: EU countries: Member countries in March 2001: Portugal (including Madeira and the Azores),1292,1001,291
E09000019,Islington,Europe: Other Europe: EU countries: Member countries in March 2001: Spain (including Canary Islands),2872,1588,1284
E09000019,Islington,Europe: Other Europe: Rest of Europe: Other Europe,4427,3275,1152
E09000019,Islington,Europe: Other Europe: Rest of Europe: Turkey,4220,3777,443
E09000019,Islington,Europe: United Kingdom: England,124561,125879,-1318
E09000019,Islington,Europe: United Kingdom: Great Britain not otherwise specified,8,8,0
E09000019,Islington,Europe: United Kingdom: Northern Ireland,1160,1502,-342
E09000019,Islington,Europe: United Kingdom: Scotland,3015,3736,-721
E09000019,Islington,Europe: United Kingdom: United Kingdom not otherwise specified,10,44,-34
E09000019,Islington,Europe: United Kingdom: Wales,1459,1926,-467
E09000019,Islington,Middle East and Asia: Central Asia,160,136,24
E09000019,Islington,Middle East and Asia: Eastern Asia: China,2079,1413,666
E09000019,Islington,Middle East and Asia: Eastern Asia: Hong Kong (Special Administrative Region of China),1102,882,220
E09000019,Islington,Middle East and Asia: Eastern Asia: Other Eastern Asia,1196,1257,-61
E09000019,Islington,Middle East and Asia: Middle East: Iran,855,722,133
E09000019,Islington,Middle East and Asia: Middle East: Other Middle East,2077,1432,645
E09000019,Islington,Middle East and Asia: South-East Asia: Other South-East Asia,1931,2031,-100
E09000019,Islington,Middle East and Asia: South-East Asia: Philippines,868,760,108
E09000019,Islington,Middle East and Asia: Southern Asia: Bangladesh,2381,2160,221
E09000019,Islington,Middle East and Asia: Southern Asia: India,1839,1424,415
E09000019,Islington,Middle East and Asia: Southern Asia: Other Southern Asia,332,311,21
E09000019,Islington,Middle East and Asia: Southern Asia: Pakistan,454,472,-18
E09000019,Islington,Middle East and Asia: Southern Asia: Sri Lanka,235,282,-47
E09000019,Islington,Other,0,0,0
E09000019,Islington,The Americas and the Caribbean: Central America: All Central American countries,318,230,88
E09000019,Islington,The Americas and the Caribbean: North America: Other North America,1262,1162,100
E09000019,Islington,The Americas and the Caribbean: North America: United States,4149,3142,1007
E09000019,Islington,The Americas and the Caribbean: South America: All South American countries,4709,3282,1427
E09000019,Islington,The Americas and the Caribbean: The Caribbean: Jamaica,1122,1452,-330
E09000019,Islington,The Americas and the Caribbean: The Caribbean: Other Caribbean,1287,1737,-450
E09000020,Kensington and Chelsea,Africa: Africa not otherwise specified,10,44,-34
E09000020,Kensington and Chelsea,Africa: Central and Western Africa: Ghana,438,332,106
E09000020,Kensington and Chelsea,Africa: Central and Western Africa: Nigeria,559,512,47
E09000020,Kensington and Chelsea,Africa: Central and Western Africa: Other Central and Western Africa,563,566,-3
E09000020,Kensington and Chelsea,Africa: North Africa,3560,3430,130
E09000020,Kensington and Chelsea,Africa: South and Eastern Africa: Kenya,304,359,-55
E09000020,Kensington and Chelsea,Africa: South and Eastern Africa: Other South and Eastern Africa,1951,1920,31
E09000020,Kensington and Chelsea,Africa: South and Eastern Africa: Somalia,807,784,23
E09000020,Kensington and Chelsea,Africa: South and Eastern Africa: South Africa,1026,1345,-319
E09000020,Kensington and Chelsea,Africa: South and Eastern Africa: Zimbabwe,171,221,-50
E09000020,Kensington and Chelsea,Antarctica and Oceania: Australasia: Australia,1684,2618,-934
E09000020,Kensington and Chelsea,Antarctica and Oceania: Australasia: Other Australasia,393,842,-449
E09000020,Kensington and Chelsea,Antarctica and Oceania: Other Oceania and Antarctica,43,49,-6
E09000020,Kensington and Chelsea,Europe: Other Europe: EU countries: Countries that joined the EU between April 2001 and March 2011: Lithuania,307,235,72
E09000020,Kensington and Chelsea,Europe: Other Europe: EU countries: Countries that joined the EU between April 2001 and March 2011: Other EU countries,1777,1728,49
E09000020,Kensington and Chelsea,Europe: Other Europe: EU countries: Countries that joined the EU between April 2001 and March 2011: Poland,1168,1325,-157
E09000020,Kensington and Chelsea,Europe: Other Europe: EU countries: Countries that joined the EU between April 2001 and March 2011: Romania,809,307,502
E09000020,Kensington and Chelsea,Europe: Other Europe: EU countries: Member countries in March 2001: France,5272,6659,-1387
E09000020,Kensington and Chelsea,Europe: Other Europe: EU countries: Member countries in March 2001: Germany,1952,2666,-714
E09000020,Kensington and Chelsea,Europe: Other Europe: EU countries: Member countries in March 2001: Ireland,1745,2757,-1012
E09000020,Kensington and Chelsea,Europe: Other Europe: EU countries: Member countries in March 2001: Italy,5518,4322,1196
E09000020,Kensington and Chelsea,Europe: Other Europe: EU countries: Member countries in March 2001: Other member countries in March 2001,4344,5228,-884
E09000020,Kensington and Chelsea,Europe: Other Europe: EU countries: Member countries in March 2001: Portugal (including Madeira and the Azores),1437,1464,-27
E09000020,Kensington and Chelsea,Europe: Other Europe: EU countries: Member countries in March 2001: Spain (including Canary Islands),2992,2690,302
E09000020,Kensington and Chelsea,Europe: Other Europe: Rest of Europe: Other Europe,5980,4786,1194
E09000020,Kensington and Chelsea,Europe: Other Europe: Rest of Europe: Turkey,1215,869,346
E09000020,Kensington and Chelsea,Europe: United Kingdom: England,63175,72290,-9115
E09000020,Kensington and Chelsea,Europe: United Kingdom: Great Britain not otherwise specified,4,16,-12
E09000020,Kensington and Chelsea,Europe: United Kingdom: Northern Ireland,468,734,-266
E09000020,Kensington and Chelsea,Europe: United Kingdom: Scotland,1682,2536,-854
E09000020,Kensington and Chelsea,Europe: United Kingdom: United Kingdom not otherwise specified,11,37,-26
E09000020,Kensington and Chelsea,Europe: United Kingdom: Wales,723,1125,-402
E09000020,Kensington and Chelsea,Middle East and Asia: Central Asia,238,214,24
E09000020,Kensington and Chelsea,Middle East and Asia: Eastern Asia: China,1890,1301,589
E09000020,Kensington and Chelsea,Middle East and Asia: Eastern Asia: Hong Kong (Special Administrative Region of China),890,996,-106
E09000020,Kensington and Chelsea,Middle East and Asia: Eastern Asia: Other Eastern Asia,1399,1659,-260
E09000020,Kensington and Chelsea,Middle East and Asia: Middle East: Iran,1841,2229,-388
E09000020,Kensington and Chelsea,Middle East and Asia: Middle East: Other Middle East,4498,4676,-178
E09000020,Kensington and Chelsea,Middle East and Asia: South-East Asia: Other South-East Asia,1948,2716,-768
E09000020,Kensington and Chelsea,Middle East and Asia: South-East Asia: Philippines,2762,2532,230
E09000020,Kensington and Chelsea,Middle East and Asia: Southern Asia: Bangladesh,591,428,163
E09000020,Kensington and Chelsea,Middle East and Asia: Southern Asia: India,1698,1521,177
E09000020,Kensington and Chelsea,Middle East and Asia: Southern Asia: Other Southern Asia,283,306,-23
E09000020,Kensington and Chelsea,Middle East and Asia: Southern Asia: Pakistan,631,530,101
E09000020,Kensington and Chelsea,Middle East and Asia: Southern Asia: Sri Lanka,295,335,-40
E09000020,Kensington and Chelsea,Other,0,0,0
E09000020,Kensington and Chelsea,The Americas and the Caribbean: Central America: All Central American countries,363,445,-82
E09000020,Kensington and Chelsea,The Americas and the Caribbean: North America: Other North America,1168,1405,-237
E09000020,Kensington and Chelsea,The Americas and the Caribbean: North America: United States,5806,7896,-2090
E09000020,Kensington and Chelsea,The Americas and the Caribbean: South America: All South American countries,3788,3203,585
E09000020,Kensington and Chelsea,The Americas and the Caribbean: The Caribbean: Jamaica,322,438,-116
E09000020,Kensington and Chelsea,The Americas and the Caribbean: The Caribbean: Other Caribbean,876,1023,-147
E09000021,Kingston upon Thames,Africa: Africa not otherwise specified,15,63,-48
E09000021,Kingston upon Thames,Africa: Central and Western Africa: Ghana,241,231,10
E09000021,Kingston upon Thames,Africa: Central and Western Africa: Nigeria,457,404,53
E09000021,Kingston upon Thames,Africa: Central and Western Africa: Other Central and Western Africa,396,356,40
E09000021,Kingston upon Thames,Africa: North Africa,987,697,290
E09000021,Kingston upon Thames,Africa: South and Eastern Africa: Kenya,706,797,-91
E09000021,Kingston upon Thames,Africa: South and Eastern Africa: Other South and Eastern Africa,1350,1442,-92
E09000021,Kingston upon Thames,Africa: South and Eastern Africa: Somalia,113,110,3
E09000021,Kingston upon Thames,Africa: South and Eastern Africa: South Africa,2059,1988,71
E09000021,Kingston upon Thames,Africa: South and Eastern Africa: Zimbabwe,452,591,-139
E09000021,Kingston upon Thames,Antarctica and Oceania: Australasia: Australia,735,697,38
E09000021,Kingston upon Thames,Antarctica and Oceania: Australasia: Other Australasia,367,401,-34
E09000021,Kingston upon Thames,Antarctica and Oceania: Other Oceania and Antarctica,36,47,-11
E09000021,Kingston upon Thames,Europe: Other Europe: EU countries: Countries that joined the EU between April 2001 and March 2011: Lithuania,572,414,158
E09000021,Kingston upon Thames,Europe: Other Europe: EU countries: Countries that joined the EU between April 2001 and March 2011: Other EU countries,3455,2053,1402
E09000021,Kingston upon Thames,Europe: Other Europe: EU countries: Countries that joined the EU between April 2001 and March 2011: Poland,2568,2146,422
E09000021,Kingston upon Thames,Europe: Other Europe: EU countries: Countries that joined the EU between April 2001 and March 2011: Romania,1157,265,892
E09000021,Kingston upon Thames,Europe: Other Europe: EU countries: Member countries in March 2001: France,1027,892,135
E09000021,Kingston upon Thames,Europe: Other Europe: EU countries: Member countries in March 2001: Germany,1544,1778,-234
E09000021,Kingston upon Thames,Europe: Other Europe: EU countries: Member countries in March 2001: Ireland,1630,1981,-351
E09000021,Kingston upon Thames,Europe: Other Europe: EU countries: Member countries in March 2001: Italy,1609,912,697
E09000021,Kingston upon Thames,Europe: Other Europe: EU countries: Member countries in March 2001: Other member countries in March 2001,1756,1499,257
E09000021,Kingston upon Thames,Europe: Other Europe: EU countries: Member countries in March 2001: Portugal (including Madeira and the Azores),862,535,327
E09000021,Kingston upon Thames,Europe: Other Europe: EU countries: Member countries in March 2001: Spain (including Canary Islands),904,527,377
E09000021,Kingston upon Thames,Europe: Other Europe: Rest of Europe: Other Europe,2941,1644,1297
E09000021,Kingston upon Thames,Europe: Other Europe: Rest of Europe: Turkey,853,338,515
E09000021,Kingston upon Thames,Europe: United Kingdom: England,107386,110113,-2727
E09000021,Kingston upon Thames,Europe: United Kingdom: Great Britain not otherwise specified,1,6,-5
E09000021,Kingston upon Thames,Europe: United Kingdom: Northern Ireland,702,801,-99
E09000021,Kingston upon Thames,Europe: United Kingdom: Scotland,1894,2230,-336
E09000021,Kingston upon Thames,Europe: United Kingdom: United Kingdom not otherwise specified,16,20,-4
E09000021,Kingston upon Thames,Europe: United Kingdom: Wales,1414,1650,-236
E09000021,Kingston upon Thames,Middle East and Asia: Central Asia,138,81,57
E09000021,Kingston upon Thames,Middle East and Asia: Eastern Asia: China,1548,875,673
E09000021,Kingston upon Thames,Middle East and Asia: Eastern Asia: Hong Kong (Special Administrative Region of China),1110,729,381
E09000021,Kingston upon Thames,Middle East and Asia: Eastern Asia: Other Eastern Asia,3296,3078,218
E09000021,Kingston upon Thames,Middle East and Asia: Middle East: Iran,1298,1046,252
E09000021,Kingston upon Thames,Middle East and Asia: Middle East: Other Middle East,3117,2223,894
E09000021,Kingston upon Thames,Middle East and Asia: South-East Asia: Other South-East Asia,1398,1773,-375
E09000021,Kingston upon Thames,Middle East and Asia: South-East Asia: Philippines,1346,735,611
E09000021,Kingston upon Thames,Middle East and Asia: Southern Asia: Bangladesh,430,444,-14
E09000021,Kingston upon Thames,Middle East and Asia: Southern Asia: India,3690,2840,850
E09000021,Kingston upon Thames,Middle East and Asia: Southern Asia: Other Southern Asia,1009,794,215
E09000021,Kingston upon Thames,Middle East and Asia: Southern Asia: Pakistan,1979,1325,654
E09000021,Kingston upon Thames,Middle East and Asia: Southern Asia: Sri Lanka,3365,3510,-145
E09000021,Kingston upon Thames,Other,1,1,0
E09000021,Kingston upon Thames,The Americas and the Caribbean: Central America: All Central American countries,129,108,21
E09000021,Kingston upon Thames,The Americas and the Caribbean: North America: Other North America,398,403,-5
E09000021,Kingston upon Thames,The Americas and the Caribbean: North America: United States,1113,897,216
E09000021,Kingston upon Thames,The Americas and the Caribbean: South America: All South American countries,1989,1091,898
E09000021,Kingston upon Thames,The Americas and the Caribbean: The Caribbean: Jamaica,183,167,16
E09000021,Kingston upon Thames,The Americas and the Caribbean: The Caribbean: Other Caribbean,322,312,10
E09000022,Lambeth,Africa: Africa not otherwise specified,55,163,-108
E09000022,Lambeth,Africa: Central and Western Africa: Ghana,4106,4413,-307
E09000022,Lambeth,Africa: Central and Western Africa: Nigeria,5139,6211,-1072
E09000022,Lambeth,Africa: Central and Western Africa: Other Central and Western Africa,4680,4860,-180
E09000022,Lambeth,Africa: North Africa,2051,1756,295
E09000022,Lambeth,Africa: South and Eastern Africa: Kenya,822,851,-29
E09000022,Lambeth,Africa: South and Eastern Africa: Other South and Eastern Africa,5196,5328,-132
E09000022,Lambeth,Africa: South and Eastern Africa: Somalia,2511,2492,19
E09000022,Lambeth,Africa: South and Eastern Africa: South Africa,2102,2167,-65
E09000022,Lambeth,Africa: South and Eastern Africa: Zimbabwe,495,637,-142
E09000022,Lambeth,Antarctica and Oceania: Australasia: Australia,2966,3970,-1004
E09000022,Lambeth,Antarctica and Oceania: Australasia: Other Australasia,1397,2196,-799
E09000022,Lambeth,Antarctica and Oceania: Other Oceania and Antarctica,107,82,25
E09000022,Lambeth,Europe: Other Europe: EU countries: Countries that joined the EU between April 2001 and March 2011: Lithuania,613,603,10
E09000022,Lambeth,Europe: Other Europe: EU countries: Countries that joined the EU between April 2001 and March 2011: Other EU countries,3696,3595,101
E09000022,Lambeth,Europe: Other Europe: EU countries: Countries that joined the EU between April 2001 and March 2011: Poland,4817,6934,-2117
E09000022,Lambeth,Europe: Other Europe: EU countries: Countries that joined the EU between April 2001 and March 2011: Romania,1553,705,848
E09000022,Lambeth,Europe: Other Europe: EU countries: Member countries in March 2001: France,3828,3667,161
E09000022,Lambeth,Europe: Other Europe: EU countries: Member countries in March 2001: Germany,2179,2338,-159
E09000022,Lambeth,Europe: Other Europe: EU countries: Member countries in March 2001: Ireland,4230,5808,-1578
E09000022,Lambeth,Europe: Other Europe: EU countries: Member countries in March 2001: Italy,5675,3679,1996
E09000022,Lambeth,Europe: Other Europe: EU countries: Member countries in March 2001: Other member countries in March 2001,3590,2969,621
E09000022,Lambeth,Europe: Other Europe: EU countries: Member countries in March 2001: Portugal (including Madeira and the Azores),7012,6992,20
E09000022,Lambeth,Europe: Other Europe: EU countries: Member countries in March 2001: Spain (including Canary Islands),4344,2130,2214
E09000022,Lambeth,Europe: Other Europe: Rest of Europe: Other Europe,3849,2745,1104
E09000022,Lambeth,Europe: Other Europe: Rest of Europe: Turkey,762,595,167
E09000022,Lambeth,Europe: United Kingdom: England,186554,176174,10380
E09000022,Lambeth,Europe: United Kingdom: Great Britain not otherwise specified,0,30,-30
E09000022,Lambeth,Europe: United Kingdom: Northern Ireland,1623,1698,-75
E09000022,Lambeth,Europe: United Kingdom: Scotland,4302,4565,-263
E09000022,Lambeth,Europe: United Kingdom: United Kingdom not otherwise specified,19,70,-51
E09000022,Lambeth,Europe: United Kingdom: Wales,2593,2800,-207
E09000022,Lambeth,Middle East and Asia: Central Asia,168,147,21
E09000022,Lambeth,Middle East and Asia: Eastern Asia: China,1797,1074,723
E09000022,Lambeth,Middle East and Asia: Eastern Asia: Hong Kong (Special Administrative Region of China),1084,904,180
E09000022,Lambeth,Middle East and Asia: Eastern Asia: Other Eastern Asia,864,829,35
E09000022,Lambeth,Middle East and Asia: Middle East: Iran,521,414,107
E09000022,Lambeth,Middle East and Asia: Middle East: Other Middle East,1838,1290,548
E09000022,Lambeth,Middle East and Asia: South-East Asia: Other South-East Asia,2480,2678,-198
E09000022,Lambeth,Middle East and Asia: South-East Asia: Philippines,1313,1354,-41
E09000022,Lambeth,Middle East and Asia: Southern Asia: Bangladesh,1019,1086,-67
E09000022,Lambeth,Middle East and Asia: Southern Asia: India,2463,2261,202
E09000022,Lambeth,Middle East and Asia: Southern Asia: Other Southern Asia,468,476,-8
E09000022,Lambeth,Middle East and Asia: Southern Asia: Pakistan,1617,1518,99
E09000022,Lambeth,Middle East and Asia: Southern Asia: Sri Lanka,416,512,-96
E09000022,Lambeth,Other,0,0,0
E09000022,Lambeth,The Americas and the Caribbean: Central America: All Central American countries,645,314,331
E09000022,Lambeth,The Americas and the Caribbean: North America: Other North America,1143,1239,-96
E09000022,Lambeth,The Americas and the Caribbean: North America: United States,3061,2483,578
E09000022,Lambeth,The Americas and the Caribbean: South America: All South American countries,13182,9038,4144
E09000022,Lambeth,The Americas and the Caribbean: The Caribbean: Jamaica,7842,9744,-1902
E09000022,Lambeth,The Americas and the Caribbean: The Caribbean: Other Caribbean,2867,2502,365
E09000023,Lewisham,Africa: Africa not otherwise specified,33,136,-103
E09000023,Lewisham,Africa: Central and Western Africa: Ghana,2838,2845,-7
E09000023,Lewisham,Africa: Central and Western Africa: Nigeria,9278,9554,-276
E09000023,Lewisham,Africa: Central and Western Africa: Other Central and Western Africa,5279,4361,918
E09000023,Lewisham,Africa: North Africa,1382,1180,202
E09000023,Lewisham,Africa: South and Eastern Africa: Kenya,571,687,-116
E09000023,Lewisham,Africa: South and Eastern Africa: Other South and Eastern Africa,2556,2943,-387
E09000023,Lewisham,Africa: South and Eastern Africa: Somalia,1342,1098,244
E09000023,Lewisham,Africa: South and Eastern Africa: South Africa,1154,1441,-287
E09000023,Lewisham,Africa: South and Eastern Africa: Zimbabwe,698,1032,-334
E09000023,Lewisham,Antarctica and Oceania: Australasia: Australia,1316,1242,74
E09000023,Lewisham,Antarctica and Oceania: Australasia: Other Australasia,674,814,-140
E09000023,Lewisham,Antarctica and Oceania: Other Oceania and Antarctica,50,55,-5
E09000023,Lewisham,Europe: Other Europe: EU countries: Countries that joined the EU between April 2001 and March 2011: Lithuania,1359,1332,27
E09000023,Lewisham,Europe: Other Europe: EU countries: Countries that joined the EU between April 2001 and March 2011: Other EU countries,5062,4181,881
E09000023,Lewisham,Europe: Other Europe: EU countries: Countries that joined the EU between April 2001 and March 2011: Poland,3841,4347,-506
E09000023,Lewisham,Europe: Other Europe: EU countries: Countries that joined the EU between April 2001 and March 2011: Romania,3924,811,3113
E09000023,Lewisham,Europe: Other Europe: EU countries: Member countries in March 2001: France,2489,2319,170
E09000023,Lewisham,Europe: Other Europe: EU countries: Member countries in March 2001: Germany,1785,1833,-48
E09000023,Lewisham,Europe: Other Europe: EU countries: Member countries in March 2001: Ireland,2942,3912,-970
E09000023,Lewisham,Europe: Other Europe: EU countries: Member countries in March 2001: Italy,4047,1922,2125
E09000023,Lewisham,Europe: Other Europe: EU countries: Member countries in March 2001: Other member countries in March 2001,2990,2198,792
E09000023,Lewisham,Europe: Other Europe: EU countries: Member countries in March 2001: Portugal (including Madeira and the Azores),1701,1012,689
E09000023,Lewisham,Europe: Other Europe: EU countries: Member countries in March 2001: Spain (including Canary Islands),2908,949,1959
E09000023,Lewisham,Europe: Other Europe: Rest of Europe: Other Europe,4457,3377,1080
E09000023,Lewisham,Europe: Other Europe: Rest of Europe: Turkey,1351,1294,57
E09000023,Lewisham,Europe: United Kingdom: England,187507,176527,10980
E09000023,Lewisham,Europe: United Kingdom: Great Britain not otherwise specified,6,24,-18
E09000023,Lewisham,Europe: United Kingdom: Northern Ireland,1167,1212,-45
E09000023,Lewisham,Europe: United Kingdom: Scotland,3052,3180,-128
E09000023,Lewisham,Europe: United Kingdom: United Kingdom not otherwise specified,20,54,-34
E09000023,Lewisham,Europe: United Kingdom: Wales,1731,1802,-71
E09000023,Lewisham,Middle East and Asia: Central Asia,149,109,40
E09000023,Lewisham,Middle East and Asia: Eastern Asia: China,2222,2077,145
E09000023,Lewisham,Middle East and Asia: Eastern Asia: Hong Kong (Special Administrative Region of China),969,734,235
E09000023,Lewisham,Middle East and Asia: Eastern Asia: Other Eastern Asia,806,918,-112
E09000023,Lewisham,Middle East and Asia: Middle East: Iran,449,443,6
E09000023,Lewisham,Middle East and Asia: Middle East: Other Middle East,1328,901,427
E09000023,Lewisham,Middle East and Asia: South-East Asia: Other South-East Asia,3265,3214,51
E09000023,Lewisham,Middle East and Asia: South-East Asia: Philippines,1087,585,502
E09000023,Lewisham,Middle East and Asia: Southern Asia: Bangladesh,775,716,59
E09000023,Lewisham,Middle East and Asia: Southern Asia: India,2554,2609,-55
E09000023,Lewisham,Middle East and Asia: Southern Asia: Other Southern Asia,1002,1079,-77
E09000023,Lewisham,Middle East and Asia: Southern Asia: Pakistan,1018,814,204
E09000023,Lewisham,Middle East and Asia: Southern Asia: Sri Lanka,3275,3548,-273
E09000023,Lewisham,Other,0,0,0
E09000023,Lewisham,The Americas and the Caribbean: Central America: All Central American countries,335,136,199
E09000023,Lewisham,The Americas and the Caribbean: North America: Other North America,798,568,230
E09000023,Lewisham,The Americas and the Caribbean: North America: United States,2078,1426,652
E09000023,Lewisham,The Americas and the Caribbean: South America: All South American countries,7173,3546,3627
E09000023,Lewisham,The Americas and the Caribbean: The Caribbean: Jamaica,8679,9697,-1018
E09000023,Lewisham,The Americas and the Caribbean: The Caribbean: Other Caribbean,3084,3091,-7
E09000024,Merton,Africa: Africa not otherwise specified,22,119,-97
E09000024,Merton,Africa: Central and Western Africa: Ghana,3037,2743,294
E09000024,Merton,Africa: Central and Western Africa: Nigeria,1338,1389,-51
E09000024,Merton,Africa: Central and Western Africa: Other Central and Western Africa,1058,885,173
E09000024,Merton,Africa: North Africa,1127,831,296
E09000024,Merton,Africa: South and Eastern Africa: Kenya,907,1019,-112
E09000024,Merton,Africa: South and Eastern Africa: Other South and Eastern Africa,2709,2767,-58
E09000024,Merton,Africa: South and Eastern Africa: Somalia,568,486,82
E09000024,Merton,Africa: South and Eastern Africa: South Africa,3636,5660,-2024
E09000024,Merton,Africa: South and Eastern Africa: Zimbabwe,713,1176,-463
E09000024,Merton,Antarctica and Oceania: Australasia: Australia,1162,1430,-268
E09000024,Merton,Antarctica and Oceania: Australasia: Other Australasia,648,875,-227
E09000024,Merton,Antarctica and Oceania: Other Oceania and Antarctica,54,39,15
E09000024,Merton,Europe: Other Europe: EU countries: Countries that joined the EU between April 2001 and March 2011: Lithuania,767,663,104
E09000024,Merton,Europe: Other Europe: EU countries: Countries that joined the EU between April 2001 and March 2011: Other EU countries,5296,2830,2466
E09000024,Merton,Europe: Other Europe: EU countries: Countries that joined the EU between April 2001 and March 2011: Poland,6934,6895,39
E09000024,Merton,Europe: Other Europe: EU countries: Countries that joined the EU between April 2001 and March 2011: Romania,2932,653,2279
E09000024,Merton,Europe: Other Europe: EU countries: Member countries in March 2001: France,1571,1305,266
E09000024,Merton,Europe: Other Europe: EU countries: Member countries in March 2001: Germany,1515,1780,-265
E09000024,Merton,Europe: Other Europe: EU countries: Member countries in March 2001: Ireland,2628,3078,-450
E09000024,Merton,Europe: Other Europe: EU countries: Member countries in March 2001: Italy,2693,1287,1406
E09000024,Merton,Europe: Other Europe: EU countries: Member countries in March 2001: Other member countries in March 2001,2119,1625,494
E09000024,Merton,Europe: Other Europe: EU countries: Member countries in March 2001: Portugal (including Madeira and the Azores),1711,948,763
E09000024,Merton,Europe: Other Europe: EU countries: Member countries in March 2001: Spain (including Canary Islands),1685,704,981
E09000024,Merton,Europe: Other Europe: Rest of Europe: Other Europe,3871,2001,1870
E09000024,Merton,Europe: Other Europe: Rest of Europe: Turkey,1048,469,579
E09000024,Merton,Europe: United Kingdom: England,122799,119465,3334
E09000024,Merton,Europe: United Kingdom: Great Britain not otherwise specified,5,16,-11
E09000024,Merton,Europe: United Kingdom: Northern Ireland,881,904,-23
E09000024,Merton,Europe: United Kingdom: Scotland,2137,2360,-223
E09000024,Merton,Europe: United Kingdom: United Kingdom not otherwise specified,8,22,-14
E09000024,Merton,Europe: United Kingdom: Wales,1415,1523,-108
E09000024,Merton,Middle East and Asia: Central Asia,148,98,50
E09000024,Merton,Middle East and Asia: Eastern Asia: China,1211,749,462
E09000024,Merton,Middle East and Asia: Eastern Asia: Hong Kong (Special Administrative Region of China),843,577,266
E09000024,Merton,Middle East and Asia: Eastern Asia: Other Eastern Asia,1824,1671,153
E09000024,Merton,Middle East and Asia: Middle East: Iran,712,621,91
E09000024,Merton,Middle East and Asia: Middle East: Other Middle East,1472,1217,255
E09000024,Merton,Middle East and Asia: South-East Asia: Other South-East Asia,1562,1629,-67
E09000024,Merton,Middle East and Asia: South-East Asia: Philippines,1473,1124,349
E09000024,Merton,Middle East and Asia: Southern Asia: Bangladesh,1092,1128,-36
E09000024,Merton,Middle East and Asia: Southern Asia: India,4701,4293,408
E09000024,Merton,Middle East and Asia: Southern Asia: Other Southern Asia,915,728,187
E09000024,Merton,Middle East and Asia: Southern Asia: Pakistan,4925,4017,908
E09000024,Merton,Middle East and Asia: Southern Asia: Sri Lanka,5595,6327,-732
E09000024,Merton,Other,0,0,0
E09000024,Merton,The Americas and the Caribbean: Central America: All Central American countries,194,122,72
E09000024,Merton,The Americas and the Caribbean: North America: Other North America,530,496,34
E09000024,Merton,The Americas and the Caribbean: North America: United States,1437,1145,292
E09000024,Merton,The Americas and the Caribbean: South America: All South American countries,4519,2450,2069
E09000024,Merton,The Americas and the Caribbean: The Caribbean: Jamaica,1988,2296,-308
E09000024,Merton,The Americas and the Caribbean: The Caribbean: Other Caribbean,1049,1058,-9
E09000025,Newham,Africa: Africa not otherwise specified,89,471,-382
E09000025,Newham,Africa: Central and Western Africa: Ghana,4085,4680,-595
E09000025,Newham,Africa: Central and Western Africa: Nigeria,5813,7545,-1732
E09000025,Newham,Africa: Central and Western Africa: Other Central and Western Africa,5336,4857,479
E09000025,Newham,Africa: North Africa,1965,1644,321
E09000025,Newham,Africa: South and Eastern Africa: Kenya,1725,2155,-430
E09000025,Newham,Africa: South and Eastern Africa: Other South and Eastern Africa,4975,5692,-717
E09000025,Newham,Africa: South and Eastern Africa: Somalia,3755,3924,-169
E09000025,Newham,Africa: South and Eastern Africa: South Africa,842,1142,-300
E09000025,Newham,Africa: South and Eastern Africa: Zimbabwe,590,827,-237
E09000025,Newham,Antarctica and Oceania: Australasia: Australia,493,449,44
E09000025,Newham,Antarctica and Oceania: Australasia: Other Australasia,260,256,4
E09000025,Newham,Antarctica and Oceania: Other Oceania and Antarctica,66,37,29
E09000025,Newham,Europe: Other Europe: EU countries: Countries that joined the EU between April 2001 and March 2011: Lithuania,6439,8348,-1909
E09000025,Newham,Europe: Other Europe: EU countries: Countries that joined the EU between April 2001 and March 2011: Other EU countries,8677,5921,2756
E09000025,Newham,Europe: Other Europe: EU countries: Countries that joined the EU between April 2001 and March 2011: Poland,4288,6142,-1854
E09000025,Newham,Europe: Other Europe: EU countries: Countries that joined the EU between April 2001 and March 2011: Romania,17455,4816,12639
E09000025,Newham,Europe: Other Europe: EU countries: Member countries in March 2001: France,1679,1418,261
E09000025,Newham,Europe: Other Europe: EU countries: Member countries in March 2001: Germany,992,1034,-42
E09000025,Newham,Europe: Other Europe: EU countries: Member countries in March 2001: Ireland,1486,1914,-428
E09000025,Newham,Europe: Other Europe: EU countries: Member countries in March 2001: Italy,7026,1119,5907
E09000025,Newham,Europe: Other Europe: EU countries: Member countries in March 2001: Other member countries in March 2001,2566,1582,984
E09000025,Newham,Europe: Other Europe: EU countries: Member countries in March 2001: Portugal (including Madeira and the Azores),2774,1762,1012
E09000025,Newham,Europe: Other Europe: EU countries: Member countries in March 2001: Spain (including Canary Islands),2512,751,1761
E09000025,Newham,Europe: Other Europe: Rest of Europe: Other Europe,8638,2908,5730
E09000025,Newham,Europe: Other Europe: Rest of Europe: Turkey,784,664,120
E09000025,Newham,Europe: United Kingdom: England,159717,139820,19897
E09000025,Newham,Europe: United Kingdom: Great Britain not otherwise specified,7,25,-18
E09000025,Newham,Europe: United Kingdom: Northern Ireland,499,500,-1
E09000025,Newham,Europe: United Kingdom: Scotland,1268,1322,-54
E09000025,Newham,Europe: United Kingdom: United Kingdom not otherwise specified,53,171,-118
E09000025,Newham,Europe: United Kingdom: Wales,903,732,171
E09000025,Newham,Middle East and Asia: Central Asia,273,226,47
E09000025,Newham,Middle East and Asia: Eastern Asia: China,2567,1407,1160
E09000025,Newham,Middle East and Asia: Eastern Asia: Hong Kong (Special Administrative Region of China),1176,706,470
E09000025,Newham,Middle East and Asia: Eastern Asia: Other Eastern Asia,657,318,339
E09000025,Newham,Middle East and Asia: Middle East: Iran,356,369,-13
E09000025,Newham,Middle East and Asia: Middle East: Other Middle East,1601,1523,78
E09000025,Newham,Middle East and Asia: South-East Asia: Other South-East Asia,2770,2416,354
E09000025,Newham,Middle East and Asia: South-East Asia: Philippines,4033,4192,-159
E09000025,Newham,Middle East and Asia: Southern Asia: Bangladesh,26860,20945,5915
E09000025,Newham,Middle East and Asia: Southern Asia: India,21818,26807,-4989
E09000025,Newham,Middle East and Asia: Southern Asia: Other Southern Asia,1514,2201,-687
E09000025,Newham,Middle East and Asia: Southern Asia: Pakistan,13826,16462,-2636
E09000025,Newham,Middle East and Asia: Southern Asia: Sri Lanka,3837,5052,-1215
E09000025,Newham,Other,0,1,-1
E09000025,Newham,The Americas and the Caribbean: Central America: All Central American countries,172,55,117
E09000025,Newham,The Americas and the Caribbean: North America: Other North America,395,244,151
E09000025,Newham,The Americas and the Caribbean: North America: United States,919,571,348
E09000025,Newham,The Americas and the Caribbean: South America: All South American countries,5455,3530,1925
E09000025,Newham,The Americas and the Caribbean: The Caribbean: Jamaica,2273,2847,-574
E09000025,Newham,The Americas and the Caribbean: The Caribbean: Other Caribbean,2782,3484,-702
E09000026,Redbridge,Africa: Africa not otherwise specified,144,415,-271
E09000026,Redbridge,Africa: Central and Western Africa: Ghana,1199,1152,47
E09000026,Redbridge,Africa: Central and Western Africa: Nigeria,2321,2049,272
E09000026,Redbridge,Africa: Central and Western Africa: Other Central and Western Africa,1716,1286,430
E09000026,Redbridge,Africa: North Africa,1160,915,245
E09000026,Redbridge,Africa: South and Eastern Africa: Kenya,3425,3800,-375
E09000026,Redbridge,Africa: South and Eastern Africa: Other South and Eastern Africa,4769,5105,-336
E09000026,Redbridge,Africa: South and Eastern Africa: Somalia,1511,1724,-213
E09000026,Redbridge,Africa: South and Eastern Africa: South Africa,676,1141,-465
E09000026,Redbridge,Africa: South and Eastern Africa: Zimbabwe,412,597,-185
E09000026,Redbridge,Antarctica and Oceania: Australasia: Australia,378,400,-22
E09000026,Redbridge,Antarctica and Oceania: Australasia: Other Australasia,166,231,-65
E09000026,Redbridge,Antarctica and Oceania: Other Oceania and Antarctica,71,40,31
E09000026,Redbridge,Europe: Other Europe: EU countries: Countries that joined the EU between April 2001 and March 2011: Lithuania,3087,2827,260
E09000026,Redbridge,Europe: Other Europe: EU countries: Countries that joined the EU between April 2001 and March 2011: Other EU countries,4626,2718,1908
E09000026,Redbridge,Europe: Other Europe: EU countries: Countries that joined the EU between April 2001 and March 2011: Poland,2583,2506,77
E09000026,Redbridge,Europe: Other Europe: EU countries: Countries that joined the EU between April 2001 and March 2011: Romania,11099,1825,9274
E09000026,Redbridge,Europe: Other Europe: EU countries: Member countries in March 2001: France,1090,1030,60
E09000026,Redbridge,Europe: Other Europe: EU countries: Member countries in March 2001: Germany,934,1142,-208
E09000026,Redbridge,Europe: Other Europe: EU countries: Member countries in March 2001: Ireland,2043,3040,-997
E09000026,Redbridge,Europe: Other Europe: EU countries: Member countries in March 2001: Italy,3428,733,2695
E09000026,Redbridge,Europe: Other Europe: EU countries: Member countries in March 2001: Other member countries in March 2001,1603,1293,310
E09000026,Redbridge,Europe: Other Europe: EU countries: Member countries in March 2001: Portugal (including Madeira and the Azores),1059,584,475
E09000026,Redbridge,Europe: Other Europe: EU countries: Member countries in March 2001: Spain (including Canary Islands),930,361,569
E09000026,Redbridge,Europe: Other Europe: Rest of Europe: Other Europe,8082,2499,5583
E09000026,Redbridge,Europe: Other Europe: Rest of Europe: Turkey,1110,889,221
E09000026,Redbridge,Europe: United Kingdom: England,172324,172349,-25
E09000026,Redbridge,Europe: United Kingdom: Great Britain not otherwise specified,8,20,-12
E09000026,Redbridge,Europe: United Kingdom: Northern Ireland,509,653,-144
E09000026,Redbridge,Europe: United Kingdom: Scotland,1270,1691,-421
E09000026,Redbridge,Europe: United Kingdom: United Kingdom not otherwise specified,38,88,-50
E09000026,Redbridge,Europe: United Kingdom: Wales,814,1096,-282
E09000026,Redbridge,Middle East and Asia: Central Asia,105,73,32
E09000026,Redbridge,Middle East and Asia: Eastern Asia: China,723,556,167
E09000026,Redbridge,Middle East and Asia: Eastern Asia: Hong Kong (Special Administrative Region of China),643,679,-36
E09000026,Redbridge,Middle East and Asia: Eastern Asia: Other Eastern Asia,259,238,21
E09000026,Redbridge,Middle East and Asia: Middle East: Iran,417,427,-10
E09000026,Redbridge,Middle East and Asia: Middle East: Other Middle East,1667,1285,382
E09000026,Redbridge,Middle East and Asia: South-East Asia: Other South-East Asia,1483,1678,-195
E09000026,Redbridge,Middle East and Asia: South-East Asia: Philippines,719,660,59
E09000026,Redbridge,Middle East and Asia: Southern Asia: Bangladesh,14099,7225,6874
E09000026,Redbridge,Middle East and Asia: Southern Asia: India,23651,21082,2569
E09000026,Redbridge,Middle East and Asia: Southern Asia: Other Southern Asia,1250,1189,61
E09000026,Redbridge,Middle East and Asia: Southern Asia: Pakistan,18479,14906,3573
E09000026,Redbridge,Middle East and Asia: Southern Asia: Sri Lanka,6866,7248,-382
E09000026,Redbridge,Other,3,3,0
E09000026,Redbridge,The Americas and the Caribbean: Central America: All Central American countries,91,48,43
E09000026,Redbridge,The Americas and the Caribbean: North America: Other North America,246,295,-49
E09000026,Redbridge,The Americas and the Caribbean: North America: United States,631,653,-22
E09000026,Redbridge,The Americas and the Caribbean: South America: All South American countries,1388,1107,281
E09000026,Redbridge,The Americas and the Caribbean: The Caribbean: Jamaica,1322,1526,-204
E09000026,Redbridge,The Americas and the Caribbean: The Caribbean: Other Caribbean,1630,1893,-263
E09000027,Richmond upon Thames,Africa: Africa not otherwise specified,17,54,-37
E09000027,Richmond upon Thames,Africa: Central and Western Africa: Ghana,215,165,50
E09000027,Richmond upon Thames,Africa: Central and Western Africa: Nigeria,368,267,101
E09000027,Richmond upon Thames,Africa: Central and Western Africa: Other Central and Western Africa,309,269,40
E09000027,Richmond upon Thames,Africa: North Africa,933,715,218
E09000027,Richmond upon Thames,Africa: South and Eastern Africa: Kenya,722,790,-68
E09000027,Richmond upon Thames,Africa: South and Eastern Africa: Other South and Eastern Africa,1105,1077,28
E09000027,Richmond upon Thames,Africa: South and Eastern Africa: Somalia,108,85,23
E09000027,Richmond upon Thames,Africa: South and Eastern Africa: South Africa,2618,2671,-53
E09000027,Richmond upon Thames,Africa: South and Eastern Africa: Zimbabwe,435,496,-61
E09000027,Richmond upon Thames,Antarctica and Oceania: Australasia: Australia,1892,2125,-233
E09000027,Richmond upon Thames,Antarctica and Oceania: Australasia: Other Australasia,856,1152,-296
E09000027,Richmond upon Thames,Antarctica and Oceania: Other Oceania and Antarctica,47,44,3
E09000027,Richmond upon Thames,Europe: Other Europe: EU countries: Countries that joined the EU between April 2001 and March 2011: Lithuania,447,213,234
E09000027,Richmond upon Thames,Europe: Other Europe: EU countries: Countries that joined the EU between April 2001 and March 2011: Other EU countries,2571,1715,856
E09000027,Richmond upon Thames,Europe: Other Europe: EU countries: Countries that joined the EU between April 2001 and March 2011: Poland,2485,2042,443
E09000027,Richmond upon Thames,Europe: Other Europe: EU countries: Countries that joined the EU between April 2001 and March 2011: Romania,944,244,700
E09000027,Richmond upon Thames,Europe: Other Europe: EU countries: Member countries in March 2001: France,1440,1353,87
E09000027,Richmond upon Thames,Europe: Other Europe: EU countries: Member countries in March 2001: Germany,2106,2335,-229
E09000027,Richmond upon Thames,Europe: Other Europe: EU countries: Member countries in March 2001: Ireland,2832,3295,-463
E09000027,Richmond upon Thames,Europe: Other Europe: EU countries: Member countries in March 2001: Italy,2042,1209,833
E09000027,Richmond upon Thames,Europe: Other Europe: EU countries: Member countries in March 2001: Other member countries in March 2001,3060,2598,462
E09000027,Richmond upon Thames,Europe: Other Europe: EU countries: Member countries in March 2001: Portugal (including Madeira and the Azores),614,328,286
E09000027,Richmond upon Thames,Europe: Other Europe: EU countries: Member countries in March 2001: Spain (including Canary Islands),1292,677,615
E09000027,Richmond upon Thames,Europe: Other Europe: Rest of Europe: Other Europe,3876,2328,1548
E09000027,Richmond upon Thames,Europe: Other Europe: Rest of Europe: Turkey,1831,387,1444
E09000027,Richmond upon Thames,Europe: United Kingdom: England,132159,133657,-1498
E09000027,Richmond upon Thames,Europe: United Kingdom: Great Britain not otherwise specified,0,4,-4
E09000027,Richmond upon Thames,Europe: United Kingdom: Northern Ireland,1172,1308,-136
E09000027,Richmond upon Thames,Europe: United Kingdom: Scotland,3403,3833,-430
E09000027,Richmond upon Thames,Europe: United Kingdom: United Kingdom not otherwise specified,9,24,-15
E09000027,Richmond upon Thames,Europe: United Kingdom: Wales,2310,2759,-449
E09000027,Richmond upon Thames,Middle East and Asia: Central Asia,148,81,67
E09000027,Richmond upon Thames,Middle East and Asia: Eastern Asia: China,1025,492,533
E09000027,Richmond upon Thames,Middle East and Asia: Eastern Asia: Hong Kong (Special Administrative Region of China),985,641,344
E09000027,Richmond upon Thames,Middle East and Asia: Eastern Asia: Other Eastern Asia,834,799,35
E09000027,Richmond upon Thames,Middle East and Asia: Middle East: Iran,1389,1161,228
E09000027,Richmond upon Thames,Middle East and Asia: Middle East: Other Middle East,1630,1254,376
E09000027,Richmond upon Thames,Middle East and Asia: South-East Asia: Other South-East Asia,1548,1429,119
E09000027,Richmond upon Thames,Middle East and Asia: South-East Asia: Philippines,504,422,82
E09000027,Richmond upon Thames,Middle East and Asia: Southern Asia: Bangladesh,425,473,-48
E09000027,Richmond upon Thames,Middle East and Asia: Southern Asia: India,3292,2412,880
E09000027,Richmond upon Thames,Middle East and Asia: Southern Asia: Other Southern Asia,1002,976,26
E09000027,Richmond upon Thames,Middle East and Asia: Southern Asia: Pakistan,775,586,189
E09000027,Richmond upon Thames,Middle East and Asia: Southern Asia: Sri Lanka,481,509,-28
E09000027,Richmond upon Thames,Other,0,0,0
E09000027,Richmond upon Thames,The Americas and the Caribbean: Central America: All Central American countries,298,188,110
E09000027,Richmond upon Thames,The Americas and the Caribbean: North America: Other North America,877,799,78
E09000027,Richmond upon Thames,The Americas and the Caribbean: North America: United States,2841,2621,220
E09000027,Richmond upon Thames,The Americas and the Caribbean: South America: All South American countries,2495,1404,1091
E09000027,Richmond upon Thames,The Americas and the Caribbean: The Caribbean: Jamaica,164,192,-28
E09000027,Richmond upon Thames,The Americas and the Caribbean: The Caribbean: Other Caribbean,346,332,14
E09000028,Southwark,Africa: Africa not otherwise specified,61,161,-100
E09000028,Southwark,Africa: Central and Western Africa: Ghana,4321,4808,-487
E09000028,Southwark,Africa: Central and Western Africa: Nigeria,11173,13588,-2415
E09000028,Southwark,Africa: Central and Western Africa: Other Central and Western Africa,7462,7676,-214
E09000028,Southwark,Africa: North Africa,2198,2063,135
E09000028,Southwark,Africa: South and Eastern Africa: Kenya,628,710,-82
E09000028,Southwark,Africa: South and Eastern Africa: Other South and Eastern Africa,3663,3655,8
E09000028,Southwark,Africa: South and Eastern Africa: Somalia,1509,1607,-98
E09000028,Southwark,Africa: South and Eastern Africa: South Africa,1387,2058,-671
E09000028,Southwark,Africa: South and Eastern Africa: Zimbabwe,517,733,-216
E09000028,Southwark,Antarctica and Oceania: Australasia: Australia,2165,2534,-369
E09000028,Southwark,Antarctica and Oceania: Australasia: Other Australasia,920,1258,-338
E09000028,Southwark,Antarctica and Oceania: Other Oceania and Antarctica,59,65,-6
E09000028,Southwark,Europe: Other Europe: EU countries: Countries that joined the EU between April 2001 and March 2011: Lithuania,889,860,29
E09000028,Southwark,Europe: Other Europe: EU countries: Countries that joined the EU between April 2001 and March 2011: Other EU countries,4580,4215,365
E09000028,Southwark,Europe: Other Europe: EU countries: Countries that joined the EU between April 2001 and March 2011: Poland,2837,3470,-633
E09000028,Southwark,Europe: Other Europe: EU countries: Countries that joined the EU between April 2001 and March 2011: Romania,1758,702,1056
E09000028,Southwark,Europe: Other Europe: EU countries: Member countries in March 2001: France,3789,3178,611
E09000028,Southwark,Europe: Other Europe: EU countries: Member countries in March 2001: Germany,2323,2361,-38
E09000028,Southwark,Europe: Other Europe: EU countries: Member countries in March 2001: Ireland,3642,4896,-1254
E09000028,Southwark,Europe: Other Europe: EU countries: Member countries in March 2001: Italy,5939,2998,2941
E09000028,Southwark,Europe: Other Europe: EU countries: Member countries in March 2001: Other member countries in March 2001,4336,3174,1162
E09000028,Southwark,Europe: Other Europe: EU countries: Member countries in March 2001: Portugal (including Madeira and the Azores),1889,1772,117
E09000028,Southwark,Europe: Other Europe: EU countries: Member countries in March 2001: Spain (including Canary Islands),4520,1902,2618
E09000028,Southwark,Europe: Other Europe: Rest of Europe: Other Europe,4485,3250,1235
E09000028,Southwark,Europe: Other Europe: Rest of Europe: Turkey,1251,1123,128
E09000028,Southwark,Europe: United Kingdom: England,175328,166947,8381
E09000028,Southwark,Europe: United Kingdom: Great Britain not otherwise specified,6,18,-12
E09000028,Southwark,Europe: United Kingdom: Northern Ireland,1508,1462,46
E09000028,Southwark,Europe: United Kingdom: Scotland,3577,3858,-281
E09000028,Southwark,Europe: United Kingdom: United Kingdom not otherwise specified,20,68,-48
E09000028,Southwark,Europe: United Kingdom: Wales,1953,2263,-310
E09000028,Southwark,Middle East and Asia: Central Asia,241,206,35
E09000028,Southwark,Middle East and Asia: Eastern Asia: China,3352,3045,307
E09000028,Southwark,Middle East and Asia: Eastern Asia: Hong Kong (Special Administrative Region of China),1477,1177,300
E09000028,Southwark,Middle East and Asia: Eastern Asia: Other Eastern Asia,1255,1354,-99
E09000028,Southwark,Middle East and Asia: Middle East: Iran,639,567,72
E09000028,Southwark,Middle East and Asia: Middle East: Other Middle East,1782,1455,327
E09000028,Southwark,Middle East and Asia: South-East Asia: Other South-East Asia,3639,3829,-190
E09000028,Southwark,Middle East and Asia: South-East Asia: Philippines,2100,1427,673
E09000028,Southwark,Middle East and Asia: Southern Asia: Bangladesh,2181,1936,245
E09000028,Southwark,Middle East and Asia: Southern Asia: India,3003,2744,259
E09000028,Southwark,Middle East and Asia: Southern Asia: Other Southern Asia,804,559,245
E09000028,Southwark,Middle East and Asia: Southern Asia: Pakistan,947,864,83
E09000028,Southwark,Middle East and Asia: Southern Asia: Sri Lanka,355,428,-73
E09000028,Southwark,Other,1,0,1
E09000028,Southwark,The Americas and the Caribbean: Central America: All Central American countries,624,288,336
E09000028,Southwark,The Americas and the Caribbean: North America: Other North America,1323,1102,221
E09000028,Southwark,The Americas and the Caribbean: North America: United States,3373,2510,863
E09000028,Southwark,The Americas and the Caribbean: South America: All South American countries,12242,7609,4633
E09000028,Southwark,The Americas and the Caribbean: The Caribbean: Jamaica,4553,5627,-1074
E09000028,Southwark,The Americas and the Caribbean: The Caribbean: Other Caribbean,3048,2123,925
E09000029,Sutton,Africa: Africa not otherwise specified,11,81,-70
E09000029,Sutton,Africa: Central and Western Africa: Ghana,1212,869,343
E09000029,Sutton,Africa: Central and Western Africa: Nigeria,1144,840,304
E09000029,Sutton,Africa: Central and Western Africa: Other Central and Western Africa,682,490,192
E09000029,Sutton,Africa: North Africa,714,476,238
E09000029,Sutton,Africa: South and Eastern Africa: Kenya,770,767,3
E09000029,Sutton,Africa: South and Eastern Africa: Other South and Eastern Africa,2213,2030,183
E09000029,Sutton,Africa: South and Eastern Africa: Somalia,127,91,36
E09000029,Sutton,Africa: South and Eastern Africa: South Africa,1645,1616,29
E09000029,Sutton,Africa: South and Eastern Africa: Zimbabwe,702,862,-160
E09000029,Sutton,Antarctica and Oceania: Australasia: Australia,413,381,32
E09000029,Sutton,Antarctica and Oceania: Australasia: Other Australasia,227,258,-31
E09000029,Sutton,Antarctica and Oceania: Other Oceania and Antarctica,32,23,9
E09000029,Sutton,Europe: Other Europe: EU countries: Countries that joined the EU between April 2001 and March 2011: Lithuania,593,346,247
E09000029,Sutton,Europe: Other Europe: EU countries: Countries that joined the EU between April 2001 and March 2011: Other EU countries,3642,1569,2073
E09000029,Sutton,Europe: Other Europe: EU countries: Countries that joined the EU between April 2001 and March 2011: Poland,3407,2100,1307
E09000029,Sutton,Europe: Other Europe: EU countries: Countries that joined the EU between April 2001 and March 2011: Romania,1890,357,1533
E09000029,Sutton,Europe: Other Europe: EU countries: Member countries in March 2001: France,630,480,150
E09000029,Sutton,Europe: Other Europe: EU countries: Member countries in March 2001: Germany,969,872,97
E09000029,Sutton,Europe: Other Europe: EU countries: Member countries in March 2001: Ireland,1925,2339,-414
E09000029,Sutton,Europe: Other Europe: EU countries: Member countries in March 2001: Italy,1212,665,547
E09000029,Sutton,Europe: Other Europe: EU countries: Member countries in March 2001: Other member countries in March 2001,1015,744,271
E09000029,Sutton,Europe: Other Europe: EU countries: Member countries in March 2001: Portugal (including Madeira and the Azores),976,488,488
E09000029,Sutton,Europe: Other Europe: EU countries: Member countries in March 2001: Spain (including Canary Islands),670,387,283
E09000029,Sutton,Europe: Other Europe: Rest of Europe: Other Europe,2468,1080,1388
E09000029,Sutton,Europe: Other Europe: Rest of Europe: Turkey,969,401,568
E09000029,Sutton,Europe: United Kingdom: England,148237,148527,-290
E09000029,Sutton,Europe: United Kingdom: Great Britain not otherwise specified,2,4,-2
E09000029,Sutton,Europe: United Kingdom: Northern Ireland,560,637,-77
E09000029,Sutton,Europe: United Kingdom: Scotland,1608,1958,-350
E09000029,Sutton,Europe: United Kingdom: United Kingdom not otherwise specified,13,18,-5
E09000029,Sutton,Europe: United Kingdom: Wales,1028,1246,-218
E09000029,Sutton,Middle East and Asia: Central Asia,118,39,79
E09000029,Sutton,Middle East and Asia: Eastern Asia: China,1412,607,805
E09000029,Sutton,Middle East and Asia: Eastern Asia: Hong Kong (Special Administrative Region of China),924,540,384
E09000029,Sutton,Middle East and Asia: Eastern Asia: Other Eastern Asia,963,788,175
E09000029,Sutton,Middle East and Asia: Middle East: Iran,667,564,103
E09000029,Sutton,Middle East and Asia: Middle East: Other Middle East,1179,923,256
E09000029,Sutton,Middle East and Asia: South-East Asia: Other South-East Asia,1336,1116,220
E09000029,Sutton,Middle East and Asia: South-East Asia: Philippines,1385,1016,369
E09000029,Sutton,Middle East and Asia: Southern Asia: Bangladesh,833,567,266
E09000029,Sutton,Middle East and Asia: Southern Asia: India,6891,3196,3695
E09000029,Sutton,Middle East and Asia: Southern Asia: Other Southern Asia,685,380,305
E09000029,Sutton,Middle East and Asia: Southern Asia: Pakistan,3109,1287,1822
E09000029,Sutton,Middle East and Asia: Southern Asia: Sri Lanka,4622,3386,1236
E09000029,Sutton,Other,0,1,-1
E09000029,Sutton,The Americas and the Caribbean: Central America: All Central American countries,83,49,34
E09000029,Sutton,The Americas and the Caribbean: North America: Other North America,233,246,-13
E09000029,Sutton,The Americas and the Caribbean: North America: United States,520,364,156
E09000029,Sutton,The Americas and the Caribbean: South America: All South American countries,1872,1052,820
E09000029,Sutton,The Americas and the Caribbean: The Caribbean: Jamaica,636,563,73
E09000029,Sutton,The Americas and the Caribbean: The Caribbean: Other Caribbean,466,460,6
E09000030,Tower Hamlets,Africa: Africa not otherwise specified,18,61,-43
E09000030,Tower Hamlets,Africa: Central and Western Africa: Ghana,838,725,113
E09000030,Tower Hamlets,Africa: Central and Western Africa: Nigeria,1459,1269,190
E09000030,Tower Hamlets,Africa: Central and Western Africa: Other Central and Western Africa,1435,1023,412
E09000030,Tower Hamlets,Africa: North Africa,2359,1509,850
E09000030,Tower Hamlets,Africa: South and Eastern Africa: Kenya,492,415,77
E09000030,Tower Hamlets,Africa: South and Eastern Africa: Other South and Eastern Africa,1725,1558,167
E09000030,Tower Hamlets,Africa: South and Eastern Africa: Somalia,3107,2925,182
E09000030,Tower Hamlets,Africa: South and Eastern Africa: South Africa,1356,1481,-125
E09000030,Tower Hamlets,Africa: South and Eastern Africa: Zimbabwe,374,376,-2
E09000030,Tower Hamlets,Antarctica and Oceania: Australasia: Australia,2239,2671,-432
E09000030,Tower Hamlets,Antarctica and Oceania: Australasia: Other Australasia,922,1249,-327
E09000030,Tower Hamlets,Antarctica and Oceania: Other Oceania and Antarctica,35,46,-11
E09000030,Tower Hamlets,Europe: Other Europe: EU countries: Countries that joined the EU between April 2001 and March 2011: Lithuania,1683,1140,543
E09000030,Tower Hamlets,Europe: Other Europe: EU countries: Countries that joined the EU between April 2001 and March 2011: Other EU countries,5095,3427,1668
E09000030,Tower Hamlets,Europe: Other Europe: EU countries: Countries that joined the EU between April 2001 and March 2011: Poland,3077,2674,403
E09000030,Tower Hamlets,Europe: Other Europe: EU countries: Countries that joined the EU between April 2001 and March 2011: Romania,2765,587,2178
E09000030,Tower Hamlets,Europe: Other Europe: EU countries: Member countries in March 2001: France,4562,3014,1548
E09000030,Tower Hamlets,Europe: Other Europe: EU countries: Member countries in March 2001: Germany,2401,2318,83
E09000030,Tower Hamlets,Europe: Other Europe: EU countries: Member countries in March 2001: Ireland,2315,2862,-547
E09000030,Tower Hamlets,Europe: Other Europe: EU countries: Member countries in March 2001: Italy,10553,3047,7506
E09000030,Tower Hamlets,Europe: Other Europe: EU countries: Member countries in March 2001: Other member countries in March 2001,4861,3401,1460
E09000030,Tower Hamlets,Europe: Other Europe: EU countries: Member countries in March 2001: Portugal (including Madeira and the Azores),1812,802,1010
E09000030,Tower Hamlets,Europe: Other Europe: EU countries: Member countries in March 2001: Spain (including Canary Islands),3791,2025,1766
E09000030,Tower Hamlets,Europe: Other Europe: Rest of Europe: Other Europe,5617,3061,2556
E09000030,Tower Hamlets,Europe: Other Europe: Rest of Europe: Turkey,1476,1005,471
E09000030,Tower Hamlets,Europe: United Kingdom: England,159957,138710,21247
E09000030,Tower Hamlets,Europe: United Kingdom: Great Britain not otherwise specified,1,16,-15
E09000030,Tower Hamlets,Europe: United Kingdom: Northern Ireland,1044,1124,-80
E09000030,Tower Hamlets,Europe: United Kingdom: Scotland,2578,3074,-496
E09000030,Tower Hamlets,Europe: United Kingdom: United Kingdom not otherwise specified,16,73,-57
E09000030,Tower Hamlets,Europe: United Kingdom: Wales,1483,1665,-182
E09000030,Tower Hamlets,Middle East and Asia: Central Asia,494,418,76
E09000030,Tower Hamlets,Middle East and Asia: Eastern Asia: China,4818,3522,1296
E09000030,Tower Hamlets,Middle East and Asia: Eastern Asia: Hong Kong (Special Administrative Region of China),1865,1218,647
E09000030,Tower Hamlets,Middle East and Asia: Eastern Asia: Other Eastern Asia,1507,1426,81
E09000030,Tower Hamlets,Middle East and Asia: Middle East: Iran,503,401,102
E09000030,Tower Hamlets,Middle East and Asia: Middle East: Other Middle East,1787,1286,501
E09000030,Tower Hamlets,Middle East and Asia: South-East Asia: Other South-East Asia,3672,3158,514
E09000030,Tower Hamlets,Middle East and Asia: South-East Asia: Philippines,1155,637,518
E09000030,Tower Hamlets,Middle East and Asia: Southern Asia: Bangladesh,43561,38877,4684
E09000030,Tower Hamlets,Middle East and Asia: Southern Asia: India,6317,3889,2428
E09000030,Tower Hamlets,Middle East and Asia: Southern Asia: Other Southern Asia,359,269,90
E09000030,Tower Hamlets,Middle East and Asia: Southern Asia: Pakistan,1566,1141,425
E09000030,Tower Hamlets,Middle East and Asia: Southern Asia: Sri Lanka,277,264,13
E09000030,Tower Hamlets,Other,0,0,0
E09000030,Tower Hamlets,The Americas and the Caribbean: Central America: All Central American countries,492,226,266
E09000030,Tower Hamlets,The Americas and the Caribbean: North America: Other North America,1094,995,99
E09000030,Tower Hamlets,The Americas and the Caribbean: North America: United States,2728,2143,585
E09000030,Tower Hamlets,The Americas and the Caribbean: South America: All South American countries,4798,2702,2096
E09000030,Tower Hamlets,The Americas and the Caribbean: The Caribbean: Jamaica,602,741,-139
E09000030,Tower Hamlets,The Americas and the Caribbean: The Caribbean: Other Caribbean,1263,1450,-187
E09000031,Waltham Forest,Africa: Africa not otherwise specified,32,141,-109
E09000031,Waltham Forest,Africa: Central and Western Africa: Ghana,2474,2824,-350
E09000031,Waltham Forest,Africa: Central and Western Africa: Nigeria,2021,2513,-492
E09000031,Waltham Forest,Africa: Central and Western Africa: Other Central and Western Africa,2207,2045,162
E09000031,Waltham Forest,Africa: North Africa,2477,2608,-131
E09000031,Waltham Forest,Africa: South and Eastern Africa: Kenya,818,956,-138
E09000031,Waltham Forest,Africa: South and Eastern Africa: Other South and Eastern Africa,3134,3833,-699
E09000031,Waltham Forest,Africa: South and Eastern Africa: Somalia,2259,2364,-105
E09000031,Waltham Forest,Africa: South and Eastern Africa: South Africa,907,1485,-578
E09000031,Waltham Forest,Africa: South and Eastern Africa: Zimbabwe,367,569,-202
E09000031,Waltham Forest,Antarctica and Oceania: Australasia: Australia,1014,604,410
E09000031,Waltham Forest,Antarctica and Oceania: Australasia: Other Australasia,509,372,137
E09000031,Waltham Forest,Antarctica and Oceania: Other Oceania and Antarctica,36,44,-8
E09000031,Waltham Forest,Europe: Other Europe: EU countries: Countries that joined the EU between April 2001 and March 2011: Lithuania,2529,3500,-971
E09000031,Waltham Forest,Europe: Other Europe: EU countries: Countries that joined the EU between April 2001 and March 2011: Other EU countries,9654,7250,2404
E09000031,Waltham Forest,Europe: Other Europe: EU countries: Countries that joined the EU between April 2001 and March 2011: Poland,5486,8197,-2711
E09000031,Waltham Forest,Europe: Other Europe: EU countries: Countries that joined the EU between April 2001 and March 2011: Romania,11015,4291,6724
E09000031,Waltham Forest,Europe: Other Europe: EU countries: Member countries in March 2001: France,1330,1340,-10
E09000031,Waltham Forest,Europe: Other Europe: EU countries: Member countries in March 2001: Germany,1167,1132,35
E09000031,Waltham Forest,Europe: Other Europe: EU countries: Member countries in March 2001: Ireland,2471,3039,-568
E09000031,Waltham Forest,Europe: Other Europe: EU countries: Member countries in March 2001: Italy,2944,1311,1633
E09000031,Waltham Forest,Europe: Other Europe: EU countries: Member countries in March 2001: Other member countries in March 2001,1884,1467,417
E09000031,Waltham Forest,Europe: Other Europe: EU countries: Member countries in March 2001: Portugal (including Madeira and the Azores),1263,994,269
E09000031,Waltham Forest,Europe: Other Europe: EU countries: Member countries in March 2001: Spain (including Canary Islands),1786,753,1033
E09000031,Waltham Forest,Europe: Other Europe: Rest of Europe: Other Europe,7189,2768,4421
E09000031,Waltham Forest,Europe: Other Europe: Rest of Europe: Turkey,3516,3279,237
E09000031,Waltham Forest,Europe: United Kingdom: England,166976,154572,12404
E09000031,Waltham Forest,Europe: United Kingdom: Great Britain not otherwise specified,3,20,-17
E09000031,Waltham Forest,Europe: United Kingdom: Northern Ireland,782,741,41
E09000031,Waltham Forest,Europe: United Kingdom: Scotland,2047,1950,97
E09000031,Waltham Forest,Europe: United Kingdom: United Kingdom not otherwise specified,19,60,-41
E09000031,Waltham Forest,Europe: United Kingdom: Wales,1244,1094,150
E09000031,Waltham Forest,Middle East and Asia: Central Asia,199,191,8
E09000031,Waltham Forest,Middle East and Asia: Eastern Asia: China,1020,1107,-87
E09000031,Waltham Forest,Middle East and Asia: Eastern Asia: Hong Kong (Special Administrative Region of China),439,391,48
E09000031,Waltham Forest,Middle East and Asia: Eastern Asia: Other Eastern Asia,368,271,97
E09000031,Waltham Forest,Middle East and Asia: Middle East: Iran,351,272,79
E09000031,Waltham Forest,Middle East and Asia: Middle East: Other Middle East,960,901,59
E09000031,Waltham Forest,Middle East and Asia: South-East Asia: Other South-East Asia,1409,1504,-95
E09000031,Waltham Forest,Middle East and Asia: South-East Asia: Philippines,1341,1233,108
E09000031,Waltham Forest,Middle East and Asia: Southern Asia: Bangladesh,2285,2696,-411
E09000031,Waltham Forest,Middle East and Asia: Southern Asia: India,3342,4150,-808
E09000031,Waltham Forest,Middle East and Asia: Southern Asia: Other Southern Asia,1144,1201,-57
E09000031,Waltham Forest,Middle East and Asia: Southern Asia: Pakistan,11035,12708,-1673
E09000031,Waltham Forest,Middle East and Asia: Southern Asia: Sri Lanka,1944,2472,-528
E09000031,Waltham Forest,Other,0,0,0
E09000031,Waltham Forest,The Americas and the Caribbean: Central America: All Central American countries,137,146,-9
E09000031,Waltham Forest,The Americas and the Caribbean: North America: Other North America,459,315,144
E09000031,Waltham Forest,The Americas and the Caribbean: North America: United States,1112,666,446
E09000031,Waltham Forest,The Americas and the Caribbean: South America: All South American countries,3147,2164,983
E09000031,Waltham Forest,The Americas and the Caribbean: The Caribbean: Jamaica,3278,4153,-875
E09000031,Waltham Forest,The Americas and the Caribbean: The Caribbean: Other Caribbean,2887,3592,-705
E09000032,Wandsworth,Africa: Africa not otherwise specified,30,170,-140
E09000032,Wandsworth,Africa: Central and Western Africa: Ghana,1819,2014,-195
E09000032,Wandsworth,Africa: Central and Western Africa: Nigeria,1594,1692,-98
E09000032,Wandsworth,Africa: Central and Western Africa: Other Central and Western Africa,1328,1183,145
E09000032,Wandsworth,Africa: North Africa,2473,1634,839
E09000032,Wandsworth,Africa: South and Eastern Africa: Kenya,1149,1323,-174
E09000032,Wandsworth,Africa: South and Eastern Africa: Other South and Eastern Africa,3653,3801,-148
E09000032,Wandsworth,Africa: South and Eastern Africa: Somalia,2630,2415,215
E09000032,Wandsworth,Africa: South and Eastern Africa: South Africa,4860,6468,-1608
E09000032,Wandsworth,Africa: South and Eastern Africa: Zimbabwe,755,964,-209
E09000032,Wandsworth,Antarctica and Oceania: Australasia: Australia,4062,5620,-1558
E09000032,Wandsworth,Antarctica and Oceania: Australasia: Other Australasia,1975,3582,-1607
E09000032,Wandsworth,Antarctica and Oceania: Other Oceania and Antarctica,64,112,-48
E09000032,Wandsworth,Europe: Other Europe: EU countries: Countries that joined the EU between April 2001 and March 2011: Lithuania,874,620,254
E09000032,Wandsworth,Europe: Other Europe: EU countries: Countries that joined the EU between April 2001 and March 2011: Other EU countries,4763,3901,862
E09000032,Wandsworth,Europe: Other Europe: EU countries: Countries that joined the EU between April 2001 and March 2011: Poland,5698,6814,-1116
E09000032,Wandsworth,Europe: Other Europe: EU countries: Countries that joined the EU between April 2001 and March 2011: Romania,1731,487,1244
E09000032,Wandsworth,Europe: Other Europe: EU countries: Member countries in March 2001: France,4629,3804,825
E09000032,Wandsworth,Europe: Other Europe: EU countries: Member countries in March 2001: Germany,2976,3347,-371
E09000032,Wandsworth,Europe: Other Europe: EU countries: Member countries in March 2001: Ireland,5062,5781,-719
E09000032,Wandsworth,Europe: Other Europe: EU countries: Member countries in March 2001: Italy,6864,3411,3453
E09000032,Wandsworth,Europe: Other Europe: EU countries: Member countries in March 2001: Other member countries in March 2001,5219,3783,1436
E09000032,Wandsworth,Europe: Other Europe: EU countries: Member countries in March 2001: Portugal (including Madeira and the Azores),2357,1504,853
E09000032,Wandsworth,Europe: Other Europe: EU countries: Member countries in March 2001: Spain (including Canary Islands),3858,1774,2084
E09000032,Wandsworth,Europe: Other Europe: Rest of Europe: Other Europe,6051,3523,2528
E09000032,Wandsworth,Europe: Other Europe: Rest of Europe: Turkey,1647,795,852
E09000032,Wandsworth,Europe: United Kingdom: England,193087,187383,5704
E09000032,Wandsworth,Europe: United Kingdom: Great Britain not otherwise specified,2,14,-12
E09000032,Wandsworth,Europe: United Kingdom: Northern Ireland,1915,1934,-19
E09000032,Wandsworth,Europe: United Kingdom: Scotland,5237,5596,-359
E09000032,Wandsworth,Europe: United Kingdom: United Kingdom not otherwise specified,18,62,-44
E09000032,Wandsworth,Europe: United Kingdom: Wales,3062,3433,-371
E09000032,Wandsworth,Middle East and Asia: Central Asia,242,136,106
E09000032,Wandsworth,Middle East and Asia: Eastern Asia: China,1627,915,712
E09000032,Wandsworth,Middle East and Asia: Eastern Asia: Hong Kong (Special Administrative Region of China),1459,997,462
E09000032,Wandsworth,Middle East and Asia: Eastern Asia: Other Eastern Asia,1392,1184,208
E09000032,Wandsworth,Middle East and Asia: Middle East: Iran,1103,902,201
E09000032,Wandsworth,Middle East and Asia: Middle East: Other Middle East,2716,1820,896
E09000032,Wandsworth,Middle East and Asia: South-East Asia: Other South-East Asia,2623,2543,80
E09000032,Wandsworth,Middle East and Asia: South-East Asia: Philippines,2713,2138,575
E09000032,Wandsworth,Middle East and Asia: Southern Asia: Bangladesh,755,759,-4
E09000032,Wandsworth,Middle East and Asia: Southern Asia: India,4280,4137,143
E09000032,Wandsworth,Middle East and Asia: Southern Asia: Other Southern Asia,1015,766,249
E09000032,Wandsworth,Middle East and Asia: Southern Asia: Pakistan,6533,5346,1187
E09000032,Wandsworth,Middle East and Asia: Southern Asia: Sri Lanka,1297,1477,-180
E09000032,Wandsworth,Other,1,0,1
E09000032,Wandsworth,The Americas and the Caribbean: Central America: All Central American countries,538,373,165
E09000032,Wandsworth,The Americas and the Caribbean: North America: Other North America,1536,1400,136
E09000032,Wandsworth,The Americas and the Caribbean: North America: United States,4486,3271,1215
E09000032,Wandsworth,The Americas and the Caribbean: South America: All South American countries,7403,4788,2615
E09000032,Wandsworth,The Americas and the Caribbean: The Caribbean: Jamaica,2944,3547,-603
E09000032,Wandsworth,The Americas and the Caribbean: The Caribbean: Other Caribbean,1397,1552,-155
E09000033,Westminster,Africa: Africa not otherwise specified,28,60,-32
E09000033,Westminster,Africa: Central and Western Africa: Ghana,376,406,-30
E09000033,Westminster,Africa: Central and Western Africa: Nigeria,1121,1151,-30
E09000033,Westminster,Africa: Central and Western Africa: Other Central and Western Africa,1381,1285,96
E09000033,Westminster,Africa: North Africa,5623,5702,-79
E09000033,Westminster,Africa: South and Eastern Africa: Kenya,556,692,-136
E09000033,Westminster,Africa: South and Eastern Africa: Other South and Eastern Africa,2392,2466,-74
E09000033,Westminster,Africa: South and Eastern Africa: Somalia,804,946,-142
E09000033,Westminster,Africa: South and Eastern Africa: South Africa,1365,1877,-512
E09000033,Westminster,Africa: South and Eastern Africa: Zimbabwe,244,324,-80
E09000033,Westminster,Antarctica and Oceania: Australasia: Australia,2097,4213,-2116
E09000033,Westminster,Antarctica and Oceania: Australasia: Other Australasia,689,1632,-943
E09000033,Westminster,Antarctica and Oceania: Other Oceania and Antarctica,91,116,-25
E09000033,Westminster,Europe: Other Europe: EU countries: Countries that joined the EU between April 2001 and March 2011: Lithuania,548,413,135
E09000033,Westminster,Europe: Other Europe: EU countries: Countries that joined the EU between April 2001 and March 2011: Other EU countries,3137,3188,-51
E09000033,Westminster,Europe: Other Europe: EU countries: Countries that joined the EU between April 2001 and March 2011: Poland,1946,1893,53
E09000033,Westminster,Europe: Other Europe: EU countries: Countries that joined the EU between April 2001 and March 2011: Romania,1428,537,891
E09000033,Westminster,Europe: Other Europe: EU countries: Member countries in March 2001: France,5675,5675,0
E09000033,Westminster,Europe: Other Europe: EU countries: Member countries in March 2001: Germany,2530,3001,-471
E09000033,Westminster,Europe: Other Europe: EU countries: Member countries in March 2001: Ireland,2346,3752,-1406
E09000033,Westminster,Europe: Other Europe: EU countries: Member countries in March 2001: Italy,6125,4333,1792
E09000033,Westminster,Europe: Other Europe: EU countries: Member countries in March 2001: Other member countries in March 2001,6612,6935,-323
E09000033,Westminster,Europe: Other Europe: EU countries: Member countries in March 2001: Portugal (including Madeira and the Azores),2200,2158,42
E09000033,Westminster,Europe: Other Europe: EU countries: Member countries in March 2001: Spain (including Canary Islands),3593,3110,483
E09000033,Westminster,Europe: Other Europe: Rest of Europe: Other Europe,8441,6900,1541
E09000033,Westminster,Europe: Other Europe: Rest of Europe: Turkey,1599,1056,543
E09000033,Westminster,Europe: United Kingdom: England,86734,96387,-9653
E09000033,Westminster,Europe: United Kingdom: Great Britain not otherwise specified,2,28,-26
E09000033,Westminster,Europe: United Kingdom: Northern Ireland,709,1037,-328
E09000033,Westminster,Europe: United Kingdom: Scotland,2166,3203,-1037
E09000033,Westminster,Europe: United Kingdom: United Kingdom not otherwise specified,11,62,-51
E09000033,Westminster,Europe: United Kingdom: Wales,1080,1690,-610
E09000033,Westminster,Middle East and Asia: Central Asia,411,499,-88
E09000033,Westminster,Middle East and Asia: Eastern Asia: China,3088,1720,1368
E09000033,Westminster,Middle East and Asia: Eastern Asia: Hong Kong (Special Administrative Region of China),1363,1376,-13
E09000033,Westminster,Middle East and Asia: Eastern Asia: Other Eastern Asia,2580,2798,-218
E09000033,Westminster,Middle East and Asia: Middle East: Iran,2458,2920,-462
E09000033,Westminster,Middle East and Asia: Middle East: Other Middle East,10224,12333,-2109
E09000033,Westminster,Middle East and Asia: South-East Asia: Other South-East Asia,3040,3660,-620
E09000033,Westminster,Middle East and Asia: South-East Asia: Philippines,2415,2275,140
E09000033,Westminster,Middle East and Asia: Southern Asia: Bangladesh,3191,2916,275
E09000033,Westminster,Middle East and Asia: Southern Asia: India,4446,3928,518
E09000033,Westminster,Middle East and Asia: Southern Asia: Other Southern Asia,673,641,32
E09000033,Westminster,Middle East and Asia: Southern Asia: Pakistan,1256,1166,90
E09000033,Westminster,Middle East and Asia: Southern Asia: Sri Lanka,489,493,-4
E09000033,Westminster,Other,0,2,-2
E09000033,Westminster,The Americas and the Caribbean: Central America: All Central American countries,549,477,72
E09000033,Westminster,The Americas and the Caribbean: North America: Other North America,1416,1840,-424
E09000033,Westminster,The Americas and the Caribbean: North America: United States,6421,7811,-1390
E09000033,Westminster,The Americas and the Caribbean: South America: All South American countries,4862,4110,752
E09000033,Westminster,The Americas and the Caribbean: The Caribbean: Jamaica,567,693,-126
E09000033,Westminster,The Americas and the Caribbean: The Caribbean: Other Caribbean,1140,1510,-370
