lad22cd,lad22nm,category,count_21,count_11,change
E09000001,City of London,"Living in a same-sex couple: Married, in a civil partnership, or cohabiting",388,244,144
E09000001,City of London,Living in an opposite-sex couple: Cohabiting,1256,750,506
E09000001,City of London,Living in an opposite-sex couple: Married or in a civil partnership,1983,1854,129
E09000001,City of London,Not living in a couple: Divorced or formerly in a civil partnership which is now legally dissolved,435,430,5
E09000001,City of London,Not living in a couple: Married or in a registered civil partnership,223,371,-148
E09000001,City of London,Not living in a couple: Single (never married and never registered a same-sex civil partnership),3155,2537,618
E09000001,City of London,Not living in a couple: Widowed or surviving partner from a civil partnership,237,268,-31
E09000001,City of London,"Separated, but still married or in a civil partnership",144,141,3
E09000002,Barking and Dagenham,"Living in a same-sex couple: Married, in a civil partnership, or cohabiting",972,1208,-236
E09000002,Barking and Dagenham,Living in an opposite-sex couple: Cohabiting,15572,12507,3065
E09000002,Barking and Dagenham,Living in an opposite-sex couple: Married or in a civil partnership,61733,52964,8769
E09000002,Barking and Dagenham,Not living in a couple: Divorced or formerly in a civil partnership which is now legally dissolved,10636,9669,967
E09000002,Barking and Dagenham,Not living in a couple: Married or in a registered civil partnership,5733,3845,1888
E09000002,Barking and Dagenham,Not living in a couple: Single (never married and never registered a same-sex civil partnership),55421,43773,11648
E09000002,Barking and Dagenham,Not living in a couple: Widowed or surviving partner from a civil partnership,6629,8058,-1429
E09000002,Barking and Dagenham,"Separated, but still married or in a civil partnership",4176,4591,-415
E09000003,Barnet,"Living in a same-sex couple: Married, in a civil partnership, or cohabiting",2470,2797,-327
E09000003,Barnet,Living in an opposite-sex couple: Cohabiting,26403,20864,5539
E09000003,Barnet,Living in an opposite-sex couple: Married or in a civil partnership,134688,123382,11306
E09000003,Barnet,Not living in a couple: Divorced or formerly in a civil partnership which is now legally dissolved,18900,16526,2374
E09000003,Barnet,Not living in a couple: Married or in a registered civil partnership,8622,7445,1177
E09000003,Barnet,Not living in a couple: Single (never married and never registered a same-sex civil partnership),94801,86175,8626
E09000003,Barnet,Not living in a couple: Widowed or surviving partner from a civil partnership,13859,14698,-839
E09000003,Barnet,"Separated, but still married or in a civil partnership",6295,6519,-224
E09000004,Bexley,"Living in a same-sex couple: Married, in a civil partnership, or cohabiting",1344,1160,184
E09000004,Bexley,Living in an opposite-sex couple: Cohabiting,22958,18570,4388
E09000004,Bexley,Living in an opposite-sex couple: Married or in a civil partnership,85744,84974,770
E09000004,Bexley,Not living in a couple: Divorced or formerly in a civil partnership which is now legally dissolved,11994,11060,934
E09000004,Bexley,Not living in a couple: Married or in a registered civil partnership,3052,2575,477
E09000004,Bexley,Not living in a couple: Single (never married and never registered a same-sex civil partnership),54417,48503,5914
E09000004,Bexley,Not living in a couple: Widowed or surviving partner from a civil partnership,11008,12200,-1192
E09000004,Bexley,"Separated, but still married or in a civil partnership",4107,4296,-189
E09000005,Brent,"Living in a same-sex couple: Married, in a civil partnership, or cohabiting",2194,2498,-304
E09000005,Brent,Living in an opposite-sex couple: Cohabiting,21111,16590,4521
E09000005,Brent,Living in an opposite-sex couple: Married or in a civil partnership,102031,93627,8404
E09000005,Brent,Not living in a couple: Divorced or formerly in a civil partnership which is now legally dissolved,15354,13270,2084
E09000005,Brent,Not living in a couple: Married or in a registered civil partnership,14288,12381,1907
E09000005,Brent,Not living in a couple: Single (never married and never registered a same-sex civil partnership),98569,89684,8885
E09000005,Brent,Not living in a couple: Widowed or surviving partner from a civil partnership,11445,11057,388
E09000005,Brent,"Separated, but still married or in a civil partnership",6164,7049,-885
E09000006,Bromley,"Living in a same-sex couple: Married, in a civil partnership, or cohabiting",2898,2051,847
E09000006,Bromley,Living in an opposite-sex couple: Cohabiting,32014,24858,7156
E09000006,Bromley,Living in an opposite-sex couple: Married or in a civil partnership,121294,116518,4776
E09000006,Bromley,Not living in a couple: Divorced or formerly in a civil partnership which is now legally dissolved,15856,15419,437
E09000006,Bromley,Not living in a couple: Married or in a registered civil partnership,3162,2949,213
E09000006,Bromley,Not living in a couple: Single (never married and never registered a same-sex civil partnership),69364,63660,5704
E09000006,Bromley,Not living in a couple: Widowed or surviving partner from a civil partnership,14017,15587,-1570
E09000006,Bromley,"Separated, but still married or in a civil partnership",4844,5495,-651
E09000007,Camden,"Living in a same-sex couple: Married, in a civil partnership, or cohabiting",3564,4346,-782
E09000007,Camden,Living in an opposite-sex couple: Cohabiting,21034,19821,1213
E09000007,Camden,Living in an opposite-sex couple: Married or in a civil partnership,49303,48595,708
E09000007,Camden,Not living in a couple: Divorced or formerly in a civil partnership which is now legally dissolved,11082,11766,-684
E09000007,Camden,Not living in a couple: Married or in a registered civil partnership,4005,5099,-1094
E09000007,Camden,Not living in a couple: Single (never married and never registered a same-sex civil partnership),72187,75991,-3804
E09000007,Camden,Not living in a couple: Widowed or surviving partner from a civil partnership,5757,7060,-1303
E09000007,Camden,"Separated, but still married or in a civil partnership",3602,4371,-769
E09000008,Croydon,"Living in a same-sex couple: Married, in a civil partnership, or cohabiting",3176,3146,30
E09000008,Croydon,Living in an opposite-sex couple: Cohabiting,33706,25399,8307
E09000008,Croydon,Living in an opposite-sex couple: Married or in a civil partnership,118812,113606,5206
E09000008,Croydon,Not living in a couple: Divorced or formerly in a civil partnership which is now legally dissolved,20135,18401,1734
E09000008,Croydon,Not living in a couple: Married or in a registered civil partnership,7216,7033,183
E09000008,Croydon,Not living in a couple: Single (never married and never registered a same-sex civil partnership),103113,91494,11619
E09000008,Croydon,Not living in a couple: Widowed or surviving partner from a civil partnership,13477,14234,-757
E09000008,Croydon,"Separated, but still married or in a civil partnership",7480,7890,-410
E09000009,Ealing,"Living in a same-sex couple: Married, in a civil partnership, or cohabiting",3002,2972,30
E09000009,Ealing,Living in an opposite-sex couple: Cohabiting,26296,21286,5010
E09000009,Ealing,Living in an opposite-sex couple: Married or in a civil partnership,117083,106450,10633
E09000009,Ealing,Not living in a couple: Divorced or formerly in a civil partnership which is now legally dissolved,17177,15160,2017
E09000009,Ealing,Not living in a couple: Married or in a registered civil partnership,12072,11030,1042
E09000009,Ealing,Not living in a couple: Single (never married and never registered a same-sex civil partnership),97381,89942,7439
E09000009,Ealing,Not living in a couple: Widowed or surviving partner from a civil partnership,12306,12636,-330
E09000009,Ealing,"Separated, but still married or in a civil partnership",5877,6509,-632
E09000010,Enfield,"Living in a same-sex couple: Married, in a civil partnership, or cohabiting",1660,2188,-528
E09000010,Enfield,Living in an opposite-sex couple: Cohabiting,21332,18274,3058
E09000010,Enfield,Living in an opposite-sex couple: Married or in a civil partnership,101542,100282,1260
E09000010,Enfield,Not living in a couple: Divorced or formerly in a civil partnership which is now legally dissolved,18053,16028,2025
E09000010,Enfield,Not living in a couple: Married or in a registered civil partnership,6825,5620,1205
E09000010,Enfield,Not living in a couple: Single (never married and never registered a same-sex civil partnership),86668,77277,9391
E09000010,Enfield,Not living in a couple: Widowed or surviving partner from a civil partnership,12222,12738,-516
E09000010,Enfield,"Separated, but still married or in a civil partnership",7006,7660,-654
E09000011,Greenwich,"Living in a same-sex couple: Married, in a civil partnership, or cohabiting",3710,2574,1136
E09000011,Greenwich,Living in an opposite-sex couple: Cohabiting,30034,21391,8643
E09000011,Greenwich,Living in an opposite-sex couple: Married or in a civil partnership,78228,70276,7952
E09000011,Greenwich,Not living in a couple: Divorced or formerly in a civil partnership which is now legally dissolved,14951,13125,1826
E09000011,Greenwich,Not living in a couple: Married or in a registered civil partnership,6188,5914,274
E09000011,Greenwich,Not living in a couple: Single (never married and never registered a same-sex civil partnership),77771,65887,11884
E09000011,Greenwich,Not living in a couple: Widowed or surviving partner from a civil partnership,8444,9450,-1006
E09000011,Greenwich,"Separated, but still married or in a civil partnership",6017,5993,24
E09000012,Hackney,"Living in a same-sex couple: Married, in a civil partnership, or cohabiting",4419,3901,518
E09000012,Hackney,Living in an opposite-sex couple: Cohabiting,29430,22733,6697
E09000012,Hackney,Living in an opposite-sex couple: Married or in a civil partnership,49743,46238,3505
E09000012,Hackney,Not living in a couple: Divorced or formerly in a civil partnership which is now legally dissolved,12346,12355,-9
E09000012,Hackney,Not living in a couple: Married or in a registered civil partnership,4513,5305,-792
E09000012,Hackney,Not living in a couple: Single (never married and never registered a same-sex civil partnership),95506,89336,6170
E09000012,Hackney,Not living in a couple: Widowed or surviving partner from a civil partnership,5684,6422,-738
E09000012,Hackney,"Separated, but still married or in a civil partnership",5501,7038,-1537
E09000013,Hammersmith and Fulham,"Living in a same-sex couple: Married, in a civil partnership, or cohabiting",2476,2606,-130
E09000013,Hammersmith and Fulham,Living in an opposite-sex couple: Cohabiting,19560,17046,2514
E09000013,Hammersmith and Fulham,Living in an opposite-sex couple: Married or in a civil partnership,42621,40917,1704
E09000013,Hammersmith and Fulham,Not living in a couple: Divorced or formerly in a civil partnership which is now legally dissolved,9606,9517,89
E09000013,Hammersmith and Fulham,Not living in a couple: Married or in a registered civil partnership,3411,3820,-409
E09000013,Hammersmith and Fulham,Not living in a couple: Single (never married and never registered a same-sex civil partnership),66742,68170,-1428
E09000013,Hammersmith and Fulham,Not living in a couple: Widowed or surviving partner from a civil partnership,4552,5254,-702
E09000013,Hammersmith and Fulham,"Separated, but still married or in a civil partnership",3102,3698,-596
E09000014,Haringey,"Living in a same-sex couple: Married, in a civil partnership, or cohabiting",3600,3853,-253
E09000014,Haringey,Living in an opposite-sex couple: Cohabiting,26925,22419,4506
E09000014,Haringey,Living in an opposite-sex couple: Married or in a civil partnership,64292,60585,3707
E09000014,Haringey,Not living in a couple: Divorced or formerly in a civil partnership which is now legally dissolved,14907,13878,1029
E09000014,Haringey,Not living in a couple: Married or in a registered civil partnership,6161,6165,-4
E09000014,Haringey,Not living in a couple: Single (never married and never registered a same-sex civil partnership),85106,80180,4926
E09000014,Haringey,Not living in a couple: Widowed or surviving partner from a civil partnership,7361,7405,-44
E09000014,Haringey,"Separated, but still married or in a civil partnership",5491,6686,-1195
E09000015,Harrow,"Living in a same-sex couple: Married, in a civil partnership, or cohabiting",901,1101,-200
E09000015,Harrow,Living in an opposite-sex couple: Cohabiting,12424,9818,2606
E09000015,Harrow,Living in an opposite-sex couple: Married or in a civil partnership,103328,95703,7625
E09000015,Harrow,Not living in a couple: Divorced or formerly in a civil partnership which is now legally dissolved,9917,8585,1332
E09000015,Harrow,Not living in a couple: Married or in a registered civil partnership,8061,6110,1951
E09000015,Harrow,Not living in a couple: Single (never married and never registered a same-sex civil partnership),58717,53266,5451
E09000015,Harrow,Not living in a couple: Widowed or surviving partner from a civil partnership,10881,11063,-182
E09000015,Harrow,"Separated, but still married or in a civil partnership",3521,3612,-91
E09000016,Havering,"Living in a same-sex couple: Married, in a civil partnership, or cohabiting",1292,986,306
E09000016,Havering,Living in an opposite-sex couple: Cohabiting,24302,18569,5733
E09000016,Havering,Living in an opposite-sex couple: Married or in a civil partnership,93658,90792,2866
E09000016,Havering,Not living in a couple: Divorced or formerly in a civil partnership which is now legally dissolved,12164,11399,765
E09000016,Havering,Not living in a couple: Married or in a registered civil partnership,3370,2232,1138
E09000016,Havering,Not living in a couple: Single (never married and never registered a same-sex civil partnership),57548,49603,7945
E09000016,Havering,Not living in a couple: Widowed or surviving partner from a civil partnership,12355,13913,-1558
E09000016,Havering,"Separated, but still married or in a civil partnership",3545,3811,-266
E09000017,Hillingdon,"Living in a same-sex couple: Married, in a civil partnership, or cohabiting",1493,1656,-163
E09000017,Hillingdon,Living in an opposite-sex couple: Cohabiting,20852,17762,3090
E09000017,Hillingdon,Living in an opposite-sex couple: Married or in a civil partnership,108441,95841,12600
E09000017,Hillingdon,Not living in a couple: Divorced or formerly in a civil partnership which is now legally dissolved,13641,12375,1266
E09000017,Hillingdon,Not living in a couple: Married or in a registered civil partnership,7293,5705,1588
E09000017,Hillingdon,Not living in a couple: Single (never married and never registered a same-sex civil partnership),68684,60518,8166
E09000017,Hillingdon,Not living in a couple: Widowed or surviving partner from a civil partnership,11540,11908,-368
E09000017,Hillingdon,"Separated, but still married or in a civil partnership",4456,4591,-135
E09000018,Hounslow,"Living in a same-sex couple: Married, in a civil partnership, or cohabiting",2265,2165,100
E09000018,Hounslow,Living in an opposite-sex couple: Cohabiting,20112,17354,2758
E09000018,Hounslow,Living in an opposite-sex couple: Married or in a civil partnership,96190,84108,12082
E09000018,Hounslow,Not living in a couple: Divorced or formerly in a civil partnership which is now legally dissolved,13744,12081,1663
E09000018,Hounslow,Not living in a couple: Married or in a registered civil partnership,9817,7259,2558
E09000018,Hounslow,Not living in a couple: Single (never married and never registered a same-sex civil partnership),70020,62839,7181
E09000018,Hounslow,Not living in a couple: Widowed or surviving partner from a civil partnership,9796,9662,134
E09000018,Hounslow,"Separated, but still married or in a civil partnership",5013,4976,37
E09000019,Islington,"Living in a same-sex couple: Married, in a civil partnership, or cohabiting",4456,4073,383
E09000019,Islington,Living in an opposite-sex couple: Cohabiting,28673,22573,6100
E09000019,Islington,Living in an opposite-sex couple: Married or in a civil partnership,41882,38800,3082
E09000019,Islington,Not living in a couple: Divorced or formerly in a civil partnership which is now legally dissolved,10665,10697,-32
E09000019,Islington,Not living in a couple: Married or in a registered civil partnership,2963,3492,-529
E09000019,Islington,Not living in a couple: Single (never married and never registered a same-sex civil partnership),80906,76767,4139
E09000019,Islington,Not living in a couple: Widowed or surviving partner from a civil partnership,5111,6163,-1052
E09000019,Islington,"Separated, but still married or in a civil partnership",3717,4762,-1045
E09000020,Kensington and Chelsea,"Living in a same-sex couple: Married, in a civil partnership, or cohabiting",1851,2673,-822
E09000020,Kensington and Chelsea,Living in an opposite-sex couple: Cohabiting,11408,12521,-1113
E09000020,Kensington and Chelsea,Living in an opposite-sex couple: Married or in a civil partnership,38266,42181,-3915
E09000020,Kensington and Chelsea,Not living in a couple: Divorced or formerly in a civil partnership which is now legally dissolved,9148,9579,-431
E09000020,Kensington and Chelsea,Not living in a couple: Married or in a registered civil partnership,4137,5060,-923
E09000020,Kensington and Chelsea,Not living in a couple: Single (never married and never registered a same-sex civil partnership),48993,51419,-2426
E09000020,Kensington and Chelsea,Not living in a couple: Widowed or surviving partner from a civil partnership,4463,4995,-532
E09000020,Kensington and Chelsea,"Separated, but still married or in a civil partnership",2542,3141,-599
E09000021,Kingston upon Thames,"Living in a same-sex couple: Married, in a civil partnership, or cohabiting",1386,1224,162
E09000021,Kingston upon Thames,Living in an opposite-sex couple: Cohabiting,15577,13104,2473
E09000021,Kingston upon Thames,Living in an opposite-sex couple: Married or in a civil partnership,60173,56910,3263
E09000021,Kingston upon Thames,Not living in a couple: Divorced or formerly in a civil partnership which is now legally dissolved,7537,6810,727
E09000021,Kingston upon Thames,Not living in a couple: Married or in a registered civil partnership,2368,2207,161
E09000021,Kingston upon Thames,Not living in a couple: Single (never married and never registered a same-sex civil partnership),37299,37508,-209
E09000021,Kingston upon Thames,Not living in a couple: Widowed or surviving partner from a civil partnership,5566,6149,-583
E09000021,Kingston upon Thames,"Separated, but still married or in a civil partnership",2206,2226,-20
E09000022,Lambeth,"Living in a same-sex couple: Married, in a civil partnership, or cohabiting",7106,6426,680
E09000022,Lambeth,Living in an opposite-sex couple: Cohabiting,39090,30120,8970
E09000022,Lambeth,Living in an opposite-sex couple: Married or in a civil partnership,58661,57396,1265
E09000022,Lambeth,Not living in a couple: Divorced or formerly in a civil partnership which is now legally dissolved,15502,14969,533
E09000022,Lambeth,Not living in a couple: Married or in a registered civil partnership,6157,6638,-481
E09000022,Lambeth,Not living in a couple: Single (never married and never registered a same-sex civil partnership),125052,114034,11018
E09000022,Lambeth,Not living in a couple: Widowed or surviving partner from a civil partnership,6855,7920,-1065
E09000022,Lambeth,"Separated, but still married or in a civil partnership",6161,7824,-1663
E09000023,Lewisham,"Living in a same-sex couple: Married, in a civil partnership, or cohabiting",4663,4404,259
E09000023,Lewisham,Living in an opposite-sex couple: Cohabiting,35207,23942,11265
E09000023,Lewisham,Living in an opposite-sex couple: Married or in a civil partnership,70632,65554,5078
E09000023,Lewisham,Not living in a couple: Divorced or formerly in a civil partnership which is now legally dissolved,15629,14533,1096
E09000023,Lewisham,Not living in a couple: Married or in a registered civil partnership,5245,5335,-90
E09000023,Lewisham,Not living in a couple: Single (never married and never registered a same-sex civil partnership),94704,85790,8914
E09000023,Lewisham,Not living in a couple: Widowed or surviving partner from a civil partnership,7749,9202,-1453
E09000023,Lewisham,"Separated, but still married or in a civil partnership",5922,7456,-1534
E09000024,Merton,"Living in a same-sex couple: Married, in a civil partnership, or cohabiting",2044,1817,227
E09000024,Merton,Living in an opposite-sex couple: Cohabiting,20785,16932,3853
E09000024,Merton,Living in an opposite-sex couple: Married or in a civil partnership,71243,67417,3826
E09000024,Merton,Not living in a couple: Divorced or formerly in a civil partnership which is now legally dissolved,9757,8706,1051
E09000024,Merton,Not living in a couple: Married or in a registered civil partnership,4427,4143,284
E09000024,Merton,Not living in a couple: Single (never married and never registered a same-sex civil partnership),53537,49544,3993
E09000024,Merton,Not living in a couple: Widowed or surviving partner from a civil partnership,6772,7505,-733
E09000024,Merton,"Separated, but still married or in a civil partnership",3139,3333,-194
E09000025,Newham,"Living in a same-sex couple: Married, in a civil partnership, or cohabiting",3365,2671,694
E09000025,Newham,Living in an opposite-sex couple: Cohabiting,26409,15451,10958
E09000025,Newham,Living in an opposite-sex couple: Married or in a civil partnership,95658,80737,14921
E09000025,Newham,Not living in a couple: Divorced or formerly in a civil partnership which is now legally dissolved,14632,12652,1980
E09000025,Newham,Not living in a couple: Married or in a registered civil partnership,13673,14133,-460
E09000025,Newham,Not living in a couple: Single (never married and never registered a same-sex civil partnership),104488,93879,10609
E09000025,Newham,Not living in a couple: Widowed or surviving partner from a civil partnership,9037,9226,-189
E09000025,Newham,"Separated, but still married or in a civil partnership",6294,7366,-1072
E09000026,Redbridge,"Living in a same-sex couple: Married, in a civil partnership, or cohabiting",1392,1838,-446
E09000026,Redbridge,Living in an opposite-sex couple: Cohabiting,16898,13406,3492
E09000026,Redbridge,Living in an opposite-sex couple: Married or in a civil partnership,112189,100791,11398
E09000026,Redbridge,Not living in a couple: Divorced or formerly in a civil partnership which is now legally dissolved,12189,10882,1307
E09000026,Redbridge,Not living in a couple: Married or in a registered civil partnership,9198,6813,2385
E09000026,Redbridge,Not living in a couple: Single (never married and never registered a same-sex civil partnership),72770,63951,8819
E09000026,Redbridge,Not living in a couple: Widowed or surviving partner from a civil partnership,11057,11694,-637
E09000026,Redbridge,"Separated, but still married or in a civil partnership",4583,5099,-516
E09000027,Richmond upon Thames,"Living in a same-sex couple: Married, in a civil partnership, or cohabiting",1918,1674,244
E09000027,Richmond upon Thames,Living in an opposite-sex couple: Cohabiting,18496,17458,1038
E09000027,Richmond upon Thames,Living in an opposite-sex couple: Married or in a civil partnership,73525,68244,5281
E09000027,Richmond upon Thames,Not living in a couple: Divorced or formerly in a civil partnership which is now legally dissolved,9721,9071,650
E09000027,Richmond upon Thames,Not living in a couple: Married or in a registered civil partnership,2242,2333,-91
E09000027,Richmond upon Thames,Not living in a couple: Single (never married and never registered a same-sex civil partnership),38745,38524,221
E09000027,Richmond upon Thames,Not living in a couple: Widowed or surviving partner from a civil partnership,6666,7298,-632
E09000027,Richmond upon Thames,"Separated, but still married or in a civil partnership",2693,2672,21
E09000028,Southwark,"Living in a same-sex couple: Married, in a civil partnership, or cohabiting",6418,6511,-93
E09000028,Southwark,Living in an opposite-sex couple: Cohabiting,36928,28226,8702
E09000028,Southwark,Living in an opposite-sex couple: Married or in a civil partnership,58713,58102,611
E09000028,Southwark,Not living in a couple: Divorced or formerly in a civil partnership which is now legally dissolved,15735,14941,794
E09000028,Southwark,Not living in a couple: Married or in a registered civil partnership,6390,7666,-1276
E09000028,Southwark,Not living in a couple: Single (never married and never registered a same-sex civil partnership),113149,97552,15597
E09000028,Southwark,Not living in a couple: Widowed or surviving partner from a civil partnership,7117,8178,-1061
E09000028,Southwark,"Separated, but still married or in a civil partnership",6587,8090,-1503
E09000029,Sutton,"Living in a same-sex couple: Married, in a civil partnership, or cohabiting",1398,1081,317
E09000029,Sutton,Living in an opposite-sex couple: Cohabiting,18752,16125,2627
E09000029,Sutton,Living in an opposite-sex couple: Married or in a civil partnership,76447,69911,6536
E09000029,Sutton,Not living in a couple: Divorced or formerly in a civil partnership which is now legally dissolved,9861,9557,304
E09000029,Sutton,Not living in a couple: Married or in a registered civil partnership,2460,2162,298
E09000029,Sutton,Not living in a couple: Single (never married and never registered a same-sex civil partnership),44240,39975,4265
E09000029,Sutton,Not living in a couple: Widowed or surviving partner from a civil partnership,8182,8618,-436
E09000029,Sutton,"Separated, but still married or in a civil partnership",3105,3287,-182
E09000030,Tower Hamlets,"Living in a same-sex couple: Married, in a civil partnership, or cohabiting",5433,3986,1447
E09000030,Tower Hamlets,Living in an opposite-sex couple: Cohabiting,33184,20651,12533
E09000030,Tower Hamlets,Living in an opposite-sex couple: Married or in a civil partnership,69479,56616,12863
E09000030,Tower Hamlets,Not living in a couple: Divorced or formerly in a civil partnership which is now legally dissolved,10462,9732,730
E09000030,Tower Hamlets,Not living in a couple: Married or in a registered civil partnership,7331,6964,367
E09000030,Tower Hamlets,Not living in a couple: Single (never married and never registered a same-sex civil partnership),109704,89494,20210
E09000030,Tower Hamlets,Not living in a couple: Widowed or surviving partner from a civil partnership,6567,7279,-712
E09000030,Tower Hamlets,"Separated, but still married or in a civil partnership",4640,5492,-852
E09000031,Waltham Forest,"Living in a same-sex couple: Married, in a civil partnership, or cohabiting",3536,3159,377
E09000031,Waltham Forest,Living in an opposite-sex couple: Cohabiting,29506,19670,9836
E09000031,Waltham Forest,Living in an opposite-sex couple: Married or in a civil partnership,78093,73153,4940
E09000031,Waltham Forest,Not living in a couple: Divorced or formerly in a civil partnership which is now legally dissolved,13321,12534,787
E09000031,Waltham Forest,Not living in a couple: Married or in a registered civil partnership,7331,7011,320
E09000031,Waltham Forest,Not living in a couple: Single (never married and never registered a same-sex civil partnership),75869,70771,5098
E09000031,Waltham Forest,Not living in a couple: Widowed or surviving partner from a civil partnership,7933,9221,-1288
E09000031,Waltham Forest,"Separated, but still married or in a civil partnership",4866,5984,-1118
E09000032,Wandsworth,"Living in a same-sex couple: Married, in a civil partnership, or cohabiting",4673,3866,807
E09000032,Wandsworth,Living in an opposite-sex couple: Cohabiting,42320,34780,7540
E09000032,Wandsworth,Living in an opposite-sex couple: Married or in a civil partnership,82063,77198,4865
E09000032,Wandsworth,Not living in a couple: Divorced or formerly in a civil partnership which is now legally dissolved,14150,13204,946
E09000032,Wandsworth,Not living in a couple: Married or in a registered civil partnership,5203,5164,39
E09000032,Wandsworth,Not living in a couple: Single (never married and never registered a same-sex civil partnership),108531,102672,5859
E09000032,Wandsworth,Not living in a couple: Widowed or surviving partner from a civil partnership,7719,8657,-938
E09000032,Wandsworth,"Separated, but still married or in a civil partnership",4407,5138,-731
E09000033,Westminster,"Living in a same-sex couple: Married, in a civil partnership, or cohabiting",3155,4096,-941
E09000033,Westminster,Living in an opposite-sex couple: Cohabiting,18454,16616,1838
E09000033,Westminster,Living in an opposite-sex couple: Married or in a civil partnership,48354,53078,-4724
E09000033,Westminster,Not living in a couple: Divorced or formerly in a civil partnership which is now legally dissolved,11524,12430,-906
E09000033,Westminster,Not living in a couple: Married or in a registered civil partnership,6404,7319,-915
E09000033,Westminster,Not living in a couple: Single (never married and never registered a same-sex civil partnership),75760,74805,955
E09000033,Westminster,Not living in a couple: Widowed or surviving partner from a civil partnership,5877,7087,-1210
E09000033,Westminster,"Separated, but still married or in a civil partnership",3868,5333,-1465
