lad22cd,lad22nm,category,count_21,count_11,change
E09000001,City of London,Africa: Central and Western Africa: Ghana,3,7,-4
E09000001,City of London,Africa: Central and Western Africa: Nigeria,7,7,0
E09000001,City of London,Africa: Central and Western Africa: Other Central and Western Africa,4,8,-4
E09000001,City of London,Africa: North Africa,28,14,14
E09000001,City of London,Africa: South and Eastern Africa: Kenya,3,2,1
E09000001,City of London,Africa: South and Eastern Africa: Other South and Eastern Africa,6,2,4
E09000001,City of London,Africa: South and Eastern Africa: Somalia,0,0,0
E09000001,City of London,Africa: South and Eastern Africa: South Africa,15,15,0
E09000001,City of London,Africa: South and Eastern Africa: Zimbabwe,3,4,-1
E09000001,City of London,Antarctica and Oceania: Australasia: Australia,114,117,-3
E09000001,City of London,Antarctica and Oceania: Australasia: New Zealand,23,42,-19
E09000001,City of London,Antarctica and Oceania: Other Antarctica and Oceania,0,0,0
E09000001,City of London,British Overseas Territories,1,1,0
E09000001,City of London,Europe: Ireland,129,126,3
E09000001,City of London,Europe: Other Europe: EU Member countries: France,201,154,47
E09000001,City of London,Europe: Other Europe: EU Member countries: Germany,128,103,25
E09000001,City of London,Europe: Other Europe: EU Member countries: Italy,257,110,147
E09000001,City of London,Europe: Other Europe: EU Member countries: Lithuania,23,17,6
E09000001,City of London,Europe: Other Europe: EU Member countries: Other EU countries,438,242,196
E09000001,City of London,Europe: Other Europe: EU Member countries: Poland,112,42,70
E09000001,City of London,Europe: Other Europe: EU Member countries: Portugal,71,27,44
E09000001,City of London,Europe: Other Europe: EU Member countries: Romania,47,12,35
E09000001,City of London,Europe: Other Europe: EU Member countries: Spain,168,76,92
E09000001,City of London,Europe: Other Europe: Rest of Europe: Other Europe,153,79,74
E09000001,City of London,Europe: Other Europe: Rest of Europe: Turkey,28,11,17
E09000001,City of London,Europe: United Kingdom,5465,5347,118
E09000001,City of London,Middle East and Asia: Central Asia,8,10,-2
E09000001,City of London,Middle East and Asia: Eastern Asia: China,232,66,166
E09000001,City of London,Middle East and Asia: Eastern Asia: Hong Kong (Special Administrative Region of China),21,5,16
E09000001,City of London,Middle East and Asia: Eastern Asia: Japan,60,48,12
E09000001,City of London,Middle East and Asia: Eastern Asia: Other Eastern Asia,29,18,11
E09000001,City of London,Middle East and Asia: Middle East: Iran,11,0,11
E09000001,City of London,Middle East and Asia: Middle East: Iraq,1,0,1
E09000001,City of London,Middle East and Asia: Middle East: Other Middle East,28,13,15
E09000001,City of London,Middle East and Asia: South-East Asia: Malaysia,36,31,5
E09000001,City of London,Middle East and Asia: South-East Asia: Other South-East Asia,14,19,-5
E09000001,City of London,Middle East and Asia: South-East Asia: Philippines,9,5,4
E09000001,City of London,Middle East and Asia: South-East Asia: Singapore,46,31,15
E09000001,City of London,Middle East and Asia: Southern Asia: Afghanistan,0,0,0
E09000001,City of London,Middle East and Asia: Southern Asia: Bangladesh,23,15,8
E09000001,City of London,Middle East and Asia: Southern Asia: India,113,61,52
E09000001,City of London,Middle East and Asia: Southern Asia: Other Southern Asia,3,1,2
E09000001,City of London,Middle East and Asia: Southern Asia: Pakistan,5,2,3
E09000001,City of London,Middle East and Asia: Southern Asia: Sri Lanka,0,3,-3
E09000001,City of London,No passport held,196,237,-41
E09000001,City of London,The Americas and the Caribbean: Central America,11,2,9
E09000001,City of London,The Americas and the Caribbean: North America: Canada,59,49,10
E09000001,City of London,The Americas and the Caribbean: North America: United States,171,148,23
E09000001,City of London,The Americas and the Caribbean: South America,74,38,36
E09000001,City of London,The Americas and the Caribbean: The Caribbean: Jamaica,0,1,-1
E09000001,City of London,The Americas and the Caribbean: The Caribbean: Other Caribbean,5,7,-2
E09000002,Barking and Dagenham,Africa: Central and Western Africa: Ghana,1202,1545,-343
E09000002,Barking and Dagenham,Africa: Central and Western Africa: Nigeria,3510,5454,-1944
E09000002,Barking and Dagenham,Africa: Central and Western Africa: Other Central and Western Africa,577,662,-85
E09000002,Barking and Dagenham,Africa: North Africa,249,151,98
E09000002,Barking and Dagenham,Africa: South and Eastern Africa: Kenya,170,278,-108
E09000002,Barking and Dagenham,Africa: South and Eastern Africa: Other South and Eastern Africa,499,751,-252
E09000002,Barking and Dagenham,Africa: South and Eastern Africa: Somalia,12,19,-7
E09000002,Barking and Dagenham,Africa: South and Eastern Africa: South Africa,61,193,-132
E09000002,Barking and Dagenham,Africa: South and Eastern Africa: Zimbabwe,211,469,-258
E09000002,Barking and Dagenham,Antarctica and Oceania: Australasia: Australia,27,65,-38
E09000002,Barking and Dagenham,Antarctica and Oceania: Australasia: New Zealand,29,46,-17
E09000002,Barking and Dagenham,Antarctica and Oceania: Other Antarctica and Oceania,4,5,-1
E09000002,Barking and Dagenham,British Overseas Territories,0,2,-2
E09000002,Barking and Dagenham,Europe: Ireland,1182,1359,-177
E09000002,Barking and Dagenham,Europe: Other Europe: EU Member countries: France,929,825,104
E09000002,Barking and Dagenham,Europe: Other Europe: EU Member countries: Germany,682,579,103
E09000002,Barking and Dagenham,Europe: Other Europe: EU Member countries: Italy,3562,509,3053
E09000002,Barking and Dagenham,Europe: Other Europe: EU Member countries: Lithuania,6408,4664,1744
E09000002,Barking and Dagenham,Europe: Other Europe: EU Member countries: Other EU countries,6515,3270,3245
E09000002,Barking and Dagenham,Europe: Other Europe: EU Member countries: Poland,2365,1974,391
E09000002,Barking and Dagenham,Europe: Other Europe: EU Member countries: Portugal,2711,1430,1281
E09000002,Barking and Dagenham,Europe: Other Europe: EU Member countries: Romania,11256,1226,10030
E09000002,Barking and Dagenham,Europe: Other Europe: EU Member countries: Spain,1131,292,839
E09000002,Barking and Dagenham,Europe: Other Europe: Rest of Europe: Other Europe,1353,463,890
E09000002,Barking and Dagenham,Europe: Other Europe: Rest of Europe: Turkey,187,180,7
E09000002,Barking and Dagenham,Europe: United Kingdom,141959,120942,21017
E09000002,Barking and Dagenham,Middle East and Asia: Central Asia,25,37,-12
E09000002,Barking and Dagenham,Middle East and Asia: Eastern Asia: China,229,251,-22
E09000002,Barking and Dagenham,Middle East and Asia: Eastern Asia: Hong Kong (Special Administrative Region of China),22,9,13
E09000002,Barking and Dagenham,Middle East and Asia: Eastern Asia: Japan,24,21,3
E09000002,Barking and Dagenham,Middle East and Asia: Eastern Asia: Other Eastern Asia,30,45,-15
E09000002,Barking and Dagenham,Middle East and Asia: Middle East: Iran,36,41,-5
E09000002,Barking and Dagenham,Middle East and Asia: Middle East: Iraq,10,10,0
E09000002,Barking and Dagenham,Middle East and Asia: Middle East: Other Middle East,41,46,-5
E09000002,Barking and Dagenham,Middle East and Asia: South-East Asia: Malaysia,117,169,-52
E09000002,Barking and Dagenham,Middle East and Asia: South-East Asia: Other South-East Asia,99,134,-35
E09000002,Barking and Dagenham,Middle East and Asia: South-East Asia: Philippines,229,332,-103
E09000002,Barking and Dagenham,Middle East and Asia: South-East Asia: Singapore,13,6,7
E09000002,Barking and Dagenham,Middle East and Asia: Southern Asia: Afghanistan,73,81,-8
E09000002,Barking and Dagenham,Middle East and Asia: Southern Asia: Bangladesh,2380,1122,1258
E09000002,Barking and Dagenham,Middle East and Asia: Southern Asia: India,3435,2731,704
E09000002,Barking and Dagenham,Middle East and Asia: Southern Asia: Other Southern Asia,140,123,17
E09000002,Barking and Dagenham,Middle East and Asia: Southern Asia: Pakistan,2523,2349,174
E09000002,Barking and Dagenham,Middle East and Asia: Southern Asia: Sri Lanka,252,395,-143
E09000002,Barking and Dagenham,No passport held,21497,29669,-8172
E09000002,Barking and Dagenham,The Americas and the Caribbean: Central America,13,13,0
E09000002,Barking and Dagenham,The Americas and the Caribbean: North America: Canada,44,64,-20
E09000002,Barking and Dagenham,The Americas and the Caribbean: North America: United States,141,183,-42
E09000002,Barking and Dagenham,The Americas and the Caribbean: South America,264,205,59
E09000002,Barking and Dagenham,The Americas and the Caribbean: The Caribbean: Jamaica,254,330,-76
E09000002,Barking and Dagenham,The Americas and the Caribbean: The Caribbean: Other Caribbean,187,192,-5
E09000003,Barnet,Africa: Central and Western Africa: Ghana,659,837,-178
E09000003,Barnet,Africa: Central and Western Africa: Nigeria,1381,2112,-731
E09000003,Barnet,Africa: Central and Western Africa: Other Central and Western Africa,390,537,-147
E09000003,Barnet,Africa: North Africa,852,557,295
E09000003,Barnet,Africa: South and Eastern Africa: Kenya,216,420,-204
E09000003,Barnet,Africa: South and Eastern Africa: Other South and Eastern Africa,538,1109,-571
E09000003,Barnet,Africa: South and Eastern Africa: Somalia,46,22,24
E09000003,Barnet,Africa: South and Eastern Africa: South Africa,531,886,-355
E09000003,Barnet,Africa: South and Eastern Africa: Zimbabwe,172,294,-122
E09000003,Barnet,Antarctica and Oceania: Australasia: Australia,627,782,-155
E09000003,Barnet,Antarctica and Oceania: Australasia: New Zealand,194,311,-117
E09000003,Barnet,Antarctica and Oceania: Other Antarctica and Oceania,19,26,-7
E09000003,Barnet,British Overseas Territories,3,18,-15
E09000003,Barnet,Europe: Ireland,5787,6846,-1059
E09000003,Barnet,Europe: Other Europe: EU Member countries: France,2529,2273,256
E09000003,Barnet,Europe: Other Europe: EU Member countries: Germany,1612,1811,-199
E09000003,Barnet,Europe: Other Europe: EU Member countries: Italy,5557,3301,2256
E09000003,Barnet,Europe: Other Europe: EU Member countries: Lithuania,1317,1174,143
E09000003,Barnet,Europe: Other Europe: EU Member countries: Other EU countries,15830,11149,4681
E09000003,Barnet,Europe: Other Europe: EU Member countries: Poland,7639,8510,-871
E09000003,Barnet,Europe: Other Europe: EU Member countries: Portugal,3768,2282,1486
E09000003,Barnet,Europe: Other Europe: EU Member countries: Romania,13297,4302,8995
E09000003,Barnet,Europe: Other Europe: EU Member countries: Spain,2771,1348,1423
E09000003,Barnet,Europe: Other Europe: Rest of Europe: Other Europe,3727,1787,1940
E09000003,Barnet,Europe: Other Europe: Rest of Europe: Turkey,1042,562,480
E09000003,Barnet,Europe: United Kingdom,282058,260916,21142
E09000003,Barnet,Middle East and Asia: Central Asia,192,146,46
E09000003,Barnet,Middle East and Asia: Eastern Asia: China,1586,1450,136
E09000003,Barnet,Middle East and Asia: Eastern Asia: Hong Kong (Special Administrative Region of China),344,87,257
E09000003,Barnet,Middle East and Asia: Eastern Asia: Japan,1898,2782,-884
E09000003,Barnet,Middle East and Asia: Eastern Asia: Other Eastern Asia,462,530,-68
E09000003,Barnet,Middle East and Asia: Middle East: Iran,1650,1501,149
E09000003,Barnet,Middle East and Asia: Middle East: Iraq,153,130,23
E09000003,Barnet,Middle East and Asia: Middle East: Other Middle East,1510,1635,-125
E09000003,Barnet,Middle East and Asia: South-East Asia: Malaysia,841,1093,-252
E09000003,Barnet,Middle East and Asia: South-East Asia: Other South-East Asia,432,569,-137
E09000003,Barnet,Middle East and Asia: South-East Asia: Philippines,1520,1635,-115
E09000003,Barnet,Middle East and Asia: South-East Asia: Singapore,169,154,15
E09000003,Barnet,Middle East and Asia: Southern Asia: Afghanistan,574,877,-303
E09000003,Barnet,Middle East and Asia: Southern Asia: Bangladesh,217,235,-18
E09000003,Barnet,Middle East and Asia: Southern Asia: India,3007,3305,-298
E09000003,Barnet,Middle East and Asia: Southern Asia: Other Southern Asia,358,705,-347
E09000003,Barnet,Middle East and Asia: Southern Asia: Pakistan,648,919,-271
E09000003,Barnet,Middle East and Asia: Southern Asia: Sri Lanka,533,955,-422
E09000003,Barnet,No passport held,16789,19813,-3024
E09000003,Barnet,The Americas and the Caribbean: Central America,112,46,66
E09000003,Barnet,The Americas and the Caribbean: North America: Canada,443,488,-45
E09000003,Barnet,The Americas and the Caribbean: North America: United States,1431,1594,-163
E09000003,Barnet,The Americas and the Caribbean: South America,1608,1132,476
E09000003,Barnet,The Americas and the Caribbean: The Caribbean: Jamaica,152,225,-73
E09000003,Barnet,The Americas and the Caribbean: The Caribbean: Other Caribbean,158,208,-50
E09000004,Bexley,Africa: Central and Western Africa: Ghana,473,501,-28
E09000004,Bexley,Africa: Central and Western Africa: Nigeria,3294,3524,-230
E09000004,Bexley,Africa: Central and Western Africa: Other Central and Western Africa,245,284,-39
E09000004,Bexley,Africa: North Africa,105,79,26
E09000004,Bexley,Africa: South and Eastern Africa: Kenya,42,86,-44
E09000004,Bexley,Africa: South and Eastern Africa: Other South and Eastern Africa,208,305,-97
E09000004,Bexley,Africa: South and Eastern Africa: Somalia,1,0,1
E09000004,Bexley,Africa: South and Eastern Africa: South Africa,172,251,-79
E09000004,Bexley,Africa: South and Eastern Africa: Zimbabwe,165,405,-240
E09000004,Bexley,Antarctica and Oceania: Australasia: Australia,116,117,-1
E09000004,Bexley,Antarctica and Oceania: Australasia: New Zealand,60,58,2
E09000004,Bexley,Antarctica and Oceania: Other Antarctica and Oceania,5,0,5
E09000004,Bexley,British Overseas Territories,2,2,0
E09000004,Bexley,Europe: Ireland,2052,1838,214
E09000004,Bexley,Europe: Other Europe: EU Member countries: France,714,517,197
E09000004,Bexley,Europe: Other Europe: EU Member countries: Germany,545,389,156
E09000004,Bexley,Europe: Other Europe: EU Member countries: Italy,1439,459,980
E09000004,Bexley,Europe: Other Europe: EU Member countries: Lithuania,1498,725,773
E09000004,Bexley,Europe: Other Europe: EU Member countries: Other EU countries,3765,1659,2106
E09000004,Bexley,Europe: Other Europe: EU Member countries: Poland,1976,1006,970
E09000004,Bexley,Europe: Other Europe: EU Member countries: Portugal,789,327,462
E09000004,Bexley,Europe: Other Europe: EU Member countries: Romania,2668,246,2422
E09000004,Bexley,Europe: Other Europe: EU Member countries: Spain,594,226,368
E09000004,Bexley,Europe: Other Europe: Rest of Europe: Other Europe,695,312,383
E09000004,Bexley,Europe: Other Europe: Rest of Europe: Turkey,199,123,76
E09000004,Bexley,Europe: United Kingdom,197062,186904,10158
E09000004,Bexley,Middle East and Asia: Central Asia,91,27,64
E09000004,Bexley,Middle East and Asia: Eastern Asia: China,515,214,301
E09000004,Bexley,Middle East and Asia: Eastern Asia: Hong Kong (Special Administrative Region of China),20,13,7
E09000004,Bexley,Middle East and Asia: Eastern Asia: Japan,85,61,24
E09000004,Bexley,Middle East and Asia: Eastern Asia: Other Eastern Asia,33,13,20
E09000004,Bexley,Middle East and Asia: Middle East: Iran,15,10,5
E09000004,Bexley,Middle East and Asia: Middle East: Iraq,18,7,11
E09000004,Bexley,Middle East and Asia: Middle East: Other Middle East,31,26,5
E09000004,Bexley,Middle East and Asia: South-East Asia: Malaysia,146,115,31
E09000004,Bexley,Middle East and Asia: South-East Asia: Other South-East Asia,152,175,-23
E09000004,Bexley,Middle East and Asia: South-East Asia: Philippines,141,132,9
E09000004,Bexley,Middle East and Asia: South-East Asia: Singapore,30,19,11
E09000004,Bexley,Middle East and Asia: Southern Asia: Afghanistan,55,29,26
E09000004,Bexley,Middle East and Asia: Southern Asia: Bangladesh,194,115,79
E09000004,Bexley,Middle East and Asia: Southern Asia: India,1797,1047,750
E09000004,Bexley,Middle East and Asia: Southern Asia: Other Southern Asia,548,183,365
E09000004,Bexley,Middle East and Asia: Southern Asia: Pakistan,197,108,89
E09000004,Bexley,Middle East and Asia: Southern Asia: Sri Lanka,296,293,3
E09000004,Bexley,No passport held,22353,28433,-6080
E09000004,Bexley,The Americas and the Caribbean: Central America,18,7,11
E09000004,Bexley,The Americas and the Caribbean: North America: Canada,90,83,7
E09000004,Bexley,The Americas and the Caribbean: North America: United States,235,192,43
E09000004,Bexley,The Americas and the Caribbean: South America,328,123,205
E09000004,Bexley,The Americas and the Caribbean: The Caribbean: Jamaica,124,149,-25
E09000004,Bexley,The Americas and the Caribbean: The Caribbean: Other Caribbean,79,80,-1
E09000005,Brent,Africa: Central and Western Africa: Ghana,704,1195,-491
E09000005,Brent,Africa: Central and Western Africa: Nigeria,774,1202,-428
E09000005,Brent,Africa: Central and Western Africa: Other Central and Western Africa,298,496,-198
E09000005,Brent,Africa: North Africa,1248,754,494
E09000005,Brent,Africa: South and Eastern Africa: Kenya,137,314,-177
E09000005,Brent,Africa: South and Eastern Africa: Other South and Eastern Africa,407,609,-202
E09000005,Brent,Africa: South and Eastern Africa: Somalia,88,68,20
E09000005,Brent,Africa: South and Eastern Africa: South Africa,162,410,-248
E09000005,Brent,Africa: South and Eastern Africa: Zimbabwe,82,167,-85
E09000005,Brent,Antarctica and Oceania: Australasia: Australia,526,946,-420
E09000005,Brent,Antarctica and Oceania: Australasia: New Zealand,248,737,-489
E09000005,Brent,Antarctica and Oceania: Other Antarctica and Oceania,19,60,-41
E09000005,Brent,British Overseas Territories,2,21,-19
E09000005,Brent,Europe: Ireland,7208,10054,-2846
E09000005,Brent,Europe: Other Europe: EU Member countries: France,2859,2451,408
E09000005,Brent,Europe: Other Europe: EU Member countries: Germany,1323,1573,-250
E09000005,Brent,Europe: Other Europe: EU Member countries: Italy,6976,3778,3198
E09000005,Brent,Europe: Other Europe: EU Member countries: Lithuania,915,1141,-226
E09000005,Brent,Europe: Other Europe: EU Member countries: Other EU countries,11459,9287,2172
E09000005,Brent,Europe: Other Europe: EU Member countries: Poland,7251,10586,-3335
E09000005,Brent,Europe: Other Europe: EU Member countries: Portugal,14218,5669,8549
E09000005,Brent,Europe: Other Europe: EU Member countries: Romania,17849,6211,11638
E09000005,Brent,Europe: Other Europe: EU Member countries: Spain,3883,1906,1977
E09000005,Brent,Europe: Other Europe: Rest of Europe: Other Europe,1958,1095,863
E09000005,Brent,Europe: Other Europe: Rest of Europe: Turkey,299,143,156
E09000005,Brent,Europe: United Kingdom,217300,202334,14966
E09000005,Brent,Middle East and Asia: Central Asia,51,135,-84
E09000005,Brent,Middle East and Asia: Eastern Asia: China,816,551,265
E09000005,Brent,Middle East and Asia: Eastern Asia: Hong Kong (Special Administrative Region of China),128,41,87
E09000005,Brent,Middle East and Asia: Eastern Asia: Japan,297,412,-115
E09000005,Brent,Middle East and Asia: Eastern Asia: Other Eastern Asia,158,156,2
E09000005,Brent,Middle East and Asia: Middle East: Iran,306,512,-206
E09000005,Brent,Middle East and Asia: Middle East: Iraq,260,230,30
E09000005,Brent,Middle East and Asia: Middle East: Other Middle East,1182,522,660
E09000005,Brent,Middle East and Asia: South-East Asia: Malaysia,433,614,-181
E09000005,Brent,Middle East and Asia: South-East Asia: Other South-East Asia,344,515,-171
E09000005,Brent,Middle East and Asia: South-East Asia: Philippines,1643,1975,-332
E09000005,Brent,Middle East and Asia: South-East Asia: Singapore,109,75,34
E09000005,Brent,Middle East and Asia: Southern Asia: Afghanistan,524,716,-192
E09000005,Brent,Middle East and Asia: Southern Asia: Bangladesh,144,170,-26
E09000005,Brent,Middle East and Asia: Southern Asia: India,11812,13046,-1234
E09000005,Brent,Middle East and Asia: Southern Asia: Other Southern Asia,818,2113,-1295
E09000005,Brent,Middle East and Asia: Southern Asia: Pakistan,1275,2077,-802
E09000005,Brent,Middle East and Asia: Southern Asia: Sri Lanka,1089,2568,-1479
E09000005,Brent,No passport held,14503,15798,-1295
E09000005,Brent,The Americas and the Caribbean: Central America,110,73,37
E09000005,Brent,The Americas and the Caribbean: North America: Canada,305,304,1
E09000005,Brent,The Americas and the Caribbean: North America: United States,876,731,145
E09000005,Brent,The Americas and the Caribbean: South America,3074,2495,579
E09000005,Brent,The Americas and the Caribbean: The Caribbean: Jamaica,1008,1660,-652
E09000005,Brent,The Americas and the Caribbean: The Caribbean: Other Caribbean,352,519,-167
E09000006,Bromley,Africa: Central and Western Africa: Ghana,314,365,-51
E09000006,Bromley,Africa: Central and Western Africa: Nigeria,1134,1135,-1
E09000006,Bromley,Africa: Central and Western Africa: Other Central and Western Africa,226,250,-24
E09000006,Bromley,Africa: North Africa,233,225,8
E09000006,Bromley,Africa: South and Eastern Africa: Kenya,55,96,-41
E09000006,Bromley,Africa: South and Eastern Africa: Other South and Eastern Africa,207,354,-147
E09000006,Bromley,Africa: South and Eastern Africa: Somalia,7,2,5
E09000006,Bromley,Africa: South and Eastern Africa: South Africa,395,638,-243
E09000006,Bromley,Africa: South and Eastern Africa: Zimbabwe,195,318,-123
E09000006,Bromley,Antarctica and Oceania: Australasia: Australia,457,445,12
E09000006,Bromley,Antarctica and Oceania: Australasia: New Zealand,229,237,-8
E09000006,Bromley,Antarctica and Oceania: Other Antarctica and Oceania,1,1,0
E09000006,Bromley,British Overseas Territories,1,4,-3
E09000006,Bromley,Europe: Ireland,3486,3199,287
E09000006,Bromley,Europe: Other Europe: EU Member countries: France,1391,1134,257
E09000006,Bromley,Europe: Other Europe: EU Member countries: Germany,835,832,3
E09000006,Bromley,Europe: Other Europe: EU Member countries: Italy,2434,1174,1260
E09000006,Bromley,Europe: Other Europe: EU Member countries: Lithuania,1310,619,691
E09000006,Bromley,Europe: Other Europe: EU Member countries: Other EU countries,5253,2793,2460
E09000006,Bromley,Europe: Other Europe: EU Member countries: Poland,2507,1750,757
E09000006,Bromley,Europe: Other Europe: EU Member countries: Portugal,1404,523,881
E09000006,Bromley,Europe: Other Europe: EU Member countries: Romania,2191,336,1855
E09000006,Bromley,Europe: Other Europe: EU Member countries: Spain,1429,510,919
E09000006,Bromley,Europe: Other Europe: Rest of Europe: Other Europe,1225,619,606
E09000006,Bromley,Europe: Other Europe: Rest of Europe: Turkey,405,184,221
E09000006,Bromley,Europe: United Kingdom,271017,256502,14515
E09000006,Bromley,Middle East and Asia: Central Asia,32,37,-5
E09000006,Bromley,Middle East and Asia: Eastern Asia: China,862,292,570
E09000006,Bromley,Middle East and Asia: Eastern Asia: Hong Kong (Special Administrative Region of China),113,31,82
E09000006,Bromley,Middle East and Asia: Eastern Asia: Japan,328,270,58
E09000006,Bromley,Middle East and Asia: Eastern Asia: Other Eastern Asia,61,51,10
E09000006,Bromley,Middle East and Asia: Middle East: Iran,70,59,11
E09000006,Bromley,Middle East and Asia: Middle East: Iraq,8,67,-59
E09000006,Bromley,Middle East and Asia: Middle East: Other Middle East,95,86,9
E09000006,Bromley,Middle East and Asia: South-East Asia: Malaysia,312,239,73
E09000006,Bromley,Middle East and Asia: South-East Asia: Other South-East Asia,147,159,-12
E09000006,Bromley,Middle East and Asia: South-East Asia: Philippines,652,353,299
E09000006,Bromley,Middle East and Asia: South-East Asia: Singapore,90,69,21
E09000006,Bromley,Middle East and Asia: Southern Asia: Afghanistan,31,32,-1
E09000006,Bromley,Middle East and Asia: Southern Asia: Bangladesh,150,139,11
E09000006,Bromley,Middle East and Asia: Southern Asia: India,2633,1248,1385
E09000006,Bromley,Middle East and Asia: Southern Asia: Other Southern Asia,79,112,-33
E09000006,Bromley,Middle East and Asia: Southern Asia: Pakistan,246,158,88
E09000006,Bromley,Middle East and Asia: Southern Asia: Sri Lanka,300,287,13
E09000006,Bromley,No passport held,22817,29602,-6785
E09000006,Bromley,The Americas and the Caribbean: Central America,53,34,19
E09000006,Bromley,The Americas and the Caribbean: North America: Canada,264,202,62
E09000006,Bromley,The Americas and the Caribbean: North America: United States,655,602,53
E09000006,Bromley,The Americas and the Caribbean: South America,1042,462,580
E09000006,Bromley,The Americas and the Caribbean: The Caribbean: Jamaica,474,411,63
E09000006,Bromley,The Americas and the Caribbean: The Caribbean: Other Caribbean,132,145,-13
E09000007,Camden,Africa: Central and Western Africa: Ghana,145,157,-12
E09000007,Camden,Africa: Central and Western Africa: Nigeria,307,421,-114
E09000007,Camden,Africa: Central and Western Africa: Other Central and Western Africa,137,216,-79
E09000007,Camden,Africa: North Africa,561,513,48
E09000007,Camden,Africa: South and Eastern Africa: Kenya,43,81,-38
E09000007,Camden,Africa: South and Eastern Africa: Other South and Eastern Africa,195,356,-161
E09000007,Camden,Africa: South and Eastern Africa: Somalia,30,39,-9
E09000007,Camden,Africa: South and Eastern Africa: South Africa,377,649,-272
E09000007,Camden,Africa: South and Eastern Africa: Zimbabwe,23,62,-39
E09000007,Camden,Antarctica and Oceania: Australasia: Australia,1384,2812,-1428
E09000007,Camden,Antarctica and Oceania: Australasia: New Zealand,437,1114,-677
E09000007,Camden,Antarctica and Oceania: Other Antarctica and Oceania,3,1,2
E09000007,Camden,British Overseas Territories,4,11,-7
E09000007,Camden,Europe: Ireland,3862,5640,-1778
E09000007,Camden,Europe: Other Europe: EU Member countries: France,5594,4364,1230
E09000007,Camden,Europe: Other Europe: EU Member countries: Germany,2101,2910,-809
E09000007,Camden,Europe: Other Europe: EU Member countries: Italy,4836,3693,1143
E09000007,Camden,Europe: Other Europe: EU Member countries: Lithuania,473,243,230
E09000007,Camden,Europe: Other Europe: EU Member countries: Other EU countries,7694,6960,734
E09000007,Camden,Europe: Other Europe: EU Member countries: Poland,1562,2012,-450
E09000007,Camden,Europe: Other Europe: EU Member countries: Portugal,1692,1511,181
E09000007,Camden,Europe: Other Europe: EU Member countries: Romania,993,304,689
E09000007,Camden,Europe: Other Europe: EU Member countries: Spain,2668,1952,716
E09000007,Camden,Europe: Other Europe: Rest of Europe: Other Europe,2284,2012,272
E09000007,Camden,Europe: Other Europe: Rest of Europe: Turkey,585,289,296
E09000007,Camden,Europe: United Kingdom,146556,151560,-5004
E09000007,Camden,Middle East and Asia: Central Asia,111,185,-74
E09000007,Camden,Middle East and Asia: Eastern Asia: China,2273,1386,887
E09000007,Camden,Middle East and Asia: Eastern Asia: Hong Kong (Special Administrative Region of China),351,205,146
E09000007,Camden,Middle East and Asia: Eastern Asia: Japan,1472,1843,-371
E09000007,Camden,Middle East and Asia: Eastern Asia: Other Eastern Asia,566,815,-249
E09000007,Camden,Middle East and Asia: Middle East: Iran,243,361,-118
E09000007,Camden,Middle East and Asia: Middle East: Iraq,30,50,-20
E09000007,Camden,Middle East and Asia: Middle East: Other Middle East,999,933,66
E09000007,Camden,Middle East and Asia: South-East Asia: Malaysia,751,1002,-251
E09000007,Camden,Middle East and Asia: South-East Asia: Other South-East Asia,382,463,-81
E09000007,Camden,Middle East and Asia: South-East Asia: Philippines,904,722,182
E09000007,Camden,Middle East and Asia: South-East Asia: Singapore,480,701,-221
E09000007,Camden,Middle East and Asia: Southern Asia: Afghanistan,50,94,-44
E09000007,Camden,Middle East and Asia: Southern Asia: Bangladesh,753,1024,-271
E09000007,Camden,Middle East and Asia: Southern Asia: India,1606,1360,246
E09000007,Camden,Middle East and Asia: Southern Asia: Other Southern Asia,39,101,-62
E09000007,Camden,Middle East and Asia: Southern Asia: Pakistan,233,283,-50
E09000007,Camden,Middle East and Asia: Southern Asia: Sri Lanka,74,154,-80
E09000007,Camden,No passport held,7475,10595,-3120
E09000007,Camden,The Americas and the Caribbean: Central America,240,250,-10
E09000007,Camden,The Americas and the Caribbean: North America: Canada,1024,1298,-274
E09000007,Camden,The Americas and the Caribbean: North America: United States,3968,5093,-1125
E09000007,Camden,The Americas and the Caribbean: South America,1356,1288,68
E09000007,Camden,The Americas and the Caribbean: The Caribbean: Jamaica,63,79,-16
E09000007,Camden,The Americas and the Caribbean: The Caribbean: Other Caribbean,141,171,-30
E09000008,Croydon,Africa: Central and Western Africa: Ghana,2512,2605,-93
E09000008,Croydon,Africa: Central and Western Africa: Nigeria,2236,2388,-152
E09000008,Croydon,Africa: Central and Western Africa: Other Central and Western Africa,839,872,-33
E09000008,Croydon,Africa: North Africa,351,290,61
E09000008,Croydon,Africa: South and Eastern Africa: Kenya,125,209,-84
E09000008,Croydon,Africa: South and Eastern Africa: Other South and Eastern Africa,1179,1964,-785
E09000008,Croydon,Africa: South and Eastern Africa: Somalia,39,10,29
E09000008,Croydon,Africa: South and Eastern Africa: South Africa,352,644,-292
E09000008,Croydon,Africa: South and Eastern Africa: Zimbabwe,337,667,-330
E09000008,Croydon,Antarctica and Oceania: Australasia: Australia,325,348,-23
E09000008,Croydon,Antarctica and Oceania: Australasia: New Zealand,206,189,17
E09000008,Croydon,Antarctica and Oceania: Other Antarctica and Oceania,1,8,-7
E09000008,Croydon,British Overseas Territories,8,13,-5
E09000008,Croydon,Europe: Ireland,3830,3972,-142
E09000008,Croydon,Europe: Other Europe: EU Member countries: France,2368,1987,381
E09000008,Croydon,Europe: Other Europe: EU Member countries: Germany,1546,1531,15
E09000008,Croydon,Europe: Other Europe: EU Member countries: Italy,4968,1784,3184
E09000008,Croydon,Europe: Other Europe: EU Member countries: Lithuania,1174,883,291
E09000008,Croydon,Europe: Other Europe: EU Member countries: Other EU countries,8606,5011,3595
E09000008,Croydon,Europe: Other Europe: EU Member countries: Poland,7845,5174,2671
E09000008,Croydon,Europe: Other Europe: EU Member countries: Portugal,4836,1752,3084
E09000008,Croydon,Europe: Other Europe: EU Member countries: Romania,5115,813,4302
E09000008,Croydon,Europe: Other Europe: EU Member countries: Spain,3618,947,2671
E09000008,Croydon,Europe: Other Europe: Rest of Europe: Other Europe,1351,694,657
E09000008,Croydon,Europe: Other Europe: Rest of Europe: Turkey,298,312,-14
E09000008,Croydon,Europe: United Kingdom,291151,272981,18170
E09000008,Croydon,Middle East and Asia: Central Asia,53,42,11
E09000008,Croydon,Middle East and Asia: Eastern Asia: China,579,604,-25
E09000008,Croydon,Middle East and Asia: Eastern Asia: Hong Kong (Special Administrative Region of China),92,30,62
E09000008,Croydon,Middle East and Asia: Eastern Asia: Japan,264,360,-96
E09000008,Croydon,Middle East and Asia: Eastern Asia: Other Eastern Asia,128,93,35
E09000008,Croydon,Middle East and Asia: Middle East: Iran,107,120,-13
E09000008,Croydon,Middle East and Asia: Middle East: Iraq,77,56,21
E09000008,Croydon,Middle East and Asia: Middle East: Other Middle East,151,51,100
E09000008,Croydon,Middle East and Asia: South-East Asia: Malaysia,301,384,-83
E09000008,Croydon,Middle East and Asia: South-East Asia: Other South-East Asia,254,300,-46
E09000008,Croydon,Middle East and Asia: South-East Asia: Philippines,430,453,-23
E09000008,Croydon,Middle East and Asia: South-East Asia: Singapore,78,86,-8
E09000008,Croydon,Middle East and Asia: Southern Asia: Afghanistan,316,275,41
E09000008,Croydon,Middle East and Asia: Southern Asia: Bangladesh,304,254,50
E09000008,Croydon,Middle East and Asia: Southern Asia: India,5409,6072,-663
E09000008,Croydon,Middle East and Asia: Southern Asia: Other Southern Asia,95,199,-104
E09000008,Croydon,Middle East and Asia: Southern Asia: Pakistan,1810,1995,-185
E09000008,Croydon,Middle East and Asia: Southern Asia: Sri Lanka,1003,1341,-338
E09000008,Croydon,No passport held,28590,37777,-9187
E09000008,Croydon,The Americas and the Caribbean: Central America,96,40,56
E09000008,Croydon,The Americas and the Caribbean: North America: Canada,271,261,10
E09000008,Croydon,The Americas and the Caribbean: North America: United States,614,596,18
E09000008,Croydon,The Americas and the Caribbean: South America,1855,848,1007
E09000008,Croydon,The Americas and the Caribbean: The Caribbean: Jamaica,2155,2556,-401
E09000008,Croydon,The Americas and the Caribbean: The Caribbean: Other Caribbean,471,537,-66
E09000009,Ealing,Africa: Central and Western Africa: Ghana,318,513,-195
E09000009,Ealing,Africa: Central and Western Africa: Nigeria,553,705,-152
E09000009,Ealing,Africa: Central and Western Africa: Other Central and Western Africa,188,253,-65
E09000009,Ealing,Africa: North Africa,1114,701,413
E09000009,Ealing,Africa: South and Eastern Africa: Kenya,133,261,-128
E09000009,Ealing,Africa: South and Eastern Africa: Other South and Eastern Africa,388,603,-215
E09000009,Ealing,Africa: South and Eastern Africa: Somalia,73,53,20
E09000009,Ealing,Africa: South and Eastern Africa: South Africa,358,922,-564
E09000009,Ealing,Africa: South and Eastern Africa: Zimbabwe,62,239,-177
E09000009,Ealing,Antarctica and Oceania: Australasia: Australia,716,1510,-794
E09000009,Ealing,Antarctica and Oceania: Australasia: New Zealand,401,1058,-657
E09000009,Ealing,Antarctica and Oceania: Other Antarctica and Oceania,13,14,-1
E09000009,Ealing,British Overseas Territories,6,10,-4
E09000009,Ealing,Europe: Ireland,6649,8420,-1771
E09000009,Ealing,Europe: Other Europe: EU Member countries: France,3186,3162,24
E09000009,Ealing,Europe: Other Europe: EU Member countries: Germany,1639,1818,-179
E09000009,Ealing,Europe: Other Europe: EU Member countries: Italy,6726,2528,4198
E09000009,Ealing,Europe: Other Europe: EU Member countries: Lithuania,1337,1392,-55
E09000009,Ealing,Europe: Other Europe: EU Member countries: Other EU countries,11968,8905,3063
E09000009,Ealing,Europe: Other Europe: EU Member countries: Poland,18242,20868,-2626
E09000009,Ealing,Europe: Other Europe: EU Member countries: Portugal,9113,2562,6551
E09000009,Ealing,Europe: Other Europe: EU Member countries: Romania,5400,943,4457
E09000009,Ealing,Europe: Other Europe: EU Member countries: Spain,3201,1462,1739
E09000009,Ealing,Europe: Other Europe: Rest of Europe: Other Europe,2739,1674,1065
E09000009,Ealing,Europe: Other Europe: Rest of Europe: Turkey,373,197,176
E09000009,Ealing,Europe: United Kingdom,244675,225561,19114
E09000009,Ealing,Middle East and Asia: Central Asia,51,116,-65
E09000009,Ealing,Middle East and Asia: Eastern Asia: China,857,662,195
E09000009,Ealing,Middle East and Asia: Eastern Asia: Hong Kong (Special Administrative Region of China),179,46,133
E09000009,Ealing,Middle East and Asia: Eastern Asia: Japan,2887,2545,342
E09000009,Ealing,Middle East and Asia: Eastern Asia: Other Eastern Asia,286,191,95
E09000009,Ealing,Middle East and Asia: Middle East: Iran,513,700,-187
E09000009,Ealing,Middle East and Asia: Middle East: Iraq,246,271,-25
E09000009,Ealing,Middle East and Asia: Middle East: Other Middle East,1668,1456,212
E09000009,Ealing,Middle East and Asia: South-East Asia: Malaysia,623,607,16
E09000009,Ealing,Middle East and Asia: South-East Asia: Other South-East Asia,318,524,-206
E09000009,Ealing,Middle East and Asia: South-East Asia: Philippines,686,725,-39
E09000009,Ealing,Middle East and Asia: South-East Asia: Singapore,162,189,-27
E09000009,Ealing,Middle East and Asia: Southern Asia: Afghanistan,656,1202,-546
E09000009,Ealing,Middle East and Asia: Southern Asia: Bangladesh,585,258,327
E09000009,Ealing,Middle East and Asia: Southern Asia: India,12104,11499,605
E09000009,Ealing,Middle East and Asia: Southern Asia: Other Southern Asia,1482,2191,-709
E09000009,Ealing,Middle East and Asia: Southern Asia: Pakistan,2005,2521,-516
E09000009,Ealing,Middle East and Asia: Southern Asia: Sri Lanka,1272,1873,-601
E09000009,Ealing,No passport held,17171,20995,-3824
E09000009,Ealing,The Americas and the Caribbean: Central America,104,66,38
E09000009,Ealing,The Americas and the Caribbean: North America: Canada,444,480,-36
E09000009,Ealing,The Americas and the Caribbean: North America: United States,1157,1067,90
E09000009,Ealing,The Americas and the Caribbean: South America,1395,978,417
E09000009,Ealing,The Americas and the Caribbean: The Caribbean: Jamaica,342,485,-143
E09000009,Ealing,The Americas and the Caribbean: The Caribbean: Other Caribbean,350,468,-118
E09000010,Enfield,Africa: Central and Western Africa: Ghana,1764,2257,-493
E09000010,Enfield,Africa: Central and Western Africa: Nigeria,1185,2059,-874
E09000010,Enfield,Africa: Central and Western Africa: Other Central and Western Africa,586,696,-110
E09000010,Enfield,Africa: North Africa,372,302,70
E09000010,Enfield,Africa: South and Eastern Africa: Kenya,76,232,-156
E09000010,Enfield,Africa: South and Eastern Africa: Other South and Eastern Africa,1080,2034,-954
E09000010,Enfield,Africa: South and Eastern Africa: Somalia,56,28,28
E09000010,Enfield,Africa: South and Eastern Africa: South Africa,141,333,-192
E09000010,Enfield,Africa: South and Eastern Africa: Zimbabwe,131,451,-320
E09000010,Enfield,Antarctica and Oceania: Australasia: Australia,256,279,-23
E09000010,Enfield,Antarctica and Oceania: Australasia: New Zealand,101,131,-30
E09000010,Enfield,Antarctica and Oceania: Other Antarctica and Oceania,9,3,6
E09000010,Enfield,British Overseas Territories,4,14,-10
E09000010,Enfield,Europe: Ireland,4224,4989,-765
E09000010,Enfield,Europe: Other Europe: EU Member countries: France,1167,1349,-182
E09000010,Enfield,Europe: Other Europe: EU Member countries: Germany,728,864,-136
E09000010,Enfield,Europe: Other Europe: EU Member countries: Italy,4249,3119,1130
E09000010,Enfield,Europe: Other Europe: EU Member countries: Lithuania,959,1009,-50
E09000010,Enfield,Europe: Other Europe: EU Member countries: Other EU countries,19284,8170,11114
E09000010,Enfield,Europe: Other Europe: EU Member countries: Poland,5998,6177,-179
E09000010,Enfield,Europe: Other Europe: EU Member countries: Portugal,2124,1041,1083
E09000010,Enfield,Europe: Other Europe: EU Member countries: Romania,6620,1651,4969
E09000010,Enfield,Europe: Other Europe: EU Member countries: Spain,1996,671,1325
E09000010,Enfield,Europe: Other Europe: Rest of Europe: Other Europe,3066,941,2125
E09000010,Enfield,Europe: Other Europe: Rest of Europe: Turkey,3734,2847,887
E09000010,Enfield,Europe: United Kingdom,243478,235819,7659
E09000010,Enfield,Middle East and Asia: Central Asia,56,61,-5
E09000010,Enfield,Middle East and Asia: Eastern Asia: China,377,305,72
E09000010,Enfield,Middle East and Asia: Eastern Asia: Hong Kong (Special Administrative Region of China),44,35,9
E09000010,Enfield,Middle East and Asia: Eastern Asia: Japan,164,176,-12
E09000010,Enfield,Middle East and Asia: Eastern Asia: Other Eastern Asia,51,41,10
E09000010,Enfield,Middle East and Asia: Middle East: Iran,200,246,-46
E09000010,Enfield,Middle East and Asia: Middle East: Iraq,36,50,-14
E09000010,Enfield,Middle East and Asia: Middle East: Other Middle East,169,117,52
E09000010,Enfield,Middle East and Asia: South-East Asia: Malaysia,252,302,-50
E09000010,Enfield,Middle East and Asia: South-East Asia: Other South-East Asia,176,164,12
E09000010,Enfield,Middle East and Asia: South-East Asia: Philippines,388,449,-61
E09000010,Enfield,Middle East and Asia: South-East Asia: Singapore,33,50,-17
E09000010,Enfield,Middle East and Asia: Southern Asia: Afghanistan,108,135,-27
E09000010,Enfield,Middle East and Asia: Southern Asia: Bangladesh,647,793,-146
E09000010,Enfield,Middle East and Asia: Southern Asia: India,791,1261,-470
E09000010,Enfield,Middle East and Asia: Southern Asia: Other Southern Asia,31,76,-45
E09000010,Enfield,Middle East and Asia: Southern Asia: Pakistan,318,337,-19
E09000010,Enfield,Middle East and Asia: Southern Asia: Sri Lanka,429,748,-319
E09000010,Enfield,No passport held,19828,26869,-7041
E09000010,Enfield,The Americas and the Caribbean: Central America,43,17,26
E09000010,Enfield,The Americas and the Caribbean: North America: Canada,135,137,-2
E09000010,Enfield,The Americas and the Caribbean: North America: United States,313,398,-85
E09000010,Enfield,The Americas and the Caribbean: South America,802,601,201
E09000010,Enfield,The Americas and the Caribbean: The Caribbean: Jamaica,897,1253,-356
E09000010,Enfield,The Americas and the Caribbean: The Caribbean: Other Caribbean,308,379,-71
E09000011,Greenwich,Africa: Central and Western Africa: Ghana,944,1245,-301
E09000011,Greenwich,Africa: Central and Western Africa: Nigeria,6158,8622,-2464
E09000011,Greenwich,Africa: Central and Western Africa: Other Central and Western Africa,715,1053,-338
E09000011,Greenwich,Africa: North Africa,344,228,116
E09000011,Greenwich,Africa: South and Eastern Africa: Kenya,149,215,-66
E09000011,Greenwich,Africa: South and Eastern Africa: Other South and Eastern Africa,622,945,-323
E09000011,Greenwich,Africa: South and Eastern Africa: Somalia,30,27,3
E09000011,Greenwich,Africa: South and Eastern Africa: South Africa,412,664,-252
E09000011,Greenwich,Africa: South and Eastern Africa: Zimbabwe,228,500,-272
E09000011,Greenwich,Antarctica and Oceania: Australasia: Australia,553,592,-39
E09000011,Greenwich,Antarctica and Oceania: Australasia: New Zealand,246,299,-53
E09000011,Greenwich,Antarctica and Oceania: Other Antarctica and Oceania,8,53,-45
E09000011,Greenwich,British Overseas Territories,1,7,-6
E09000011,Greenwich,Europe: Ireland,3535,3377,158
E09000011,Greenwich,Europe: Other Europe: EU Member countries: France,2564,1889,675
E09000011,Greenwich,Europe: Other Europe: EU Member countries: Germany,1434,1305,129
E09000011,Greenwich,Europe: Other Europe: EU Member countries: Italy,4096,1425,2671
E09000011,Greenwich,Europe: Other Europe: EU Member countries: Lithuania,3184,2260,924
E09000011,Greenwich,Europe: Other Europe: EU Member countries: Other EU countries,9981,5991,3990
E09000011,Greenwich,Europe: Other Europe: EU Member countries: Poland,3263,2518,745
E09000011,Greenwich,Europe: Other Europe: EU Member countries: Portugal,2560,902,1658
E09000011,Greenwich,Europe: Other Europe: EU Member countries: Romania,5401,944,4457
E09000011,Greenwich,Europe: Other Europe: EU Member countries: Spain,2652,752,1900
E09000011,Greenwich,Europe: Other Europe: Rest of Europe: Other Europe,2069,911,1158
E09000011,Greenwich,Europe: Other Europe: Rest of Europe: Turkey,559,321,238
E09000011,Greenwich,Europe: United Kingdom,196790,172792,23998
E09000011,Greenwich,Middle East and Asia: Central Asia,110,69,41
E09000011,Greenwich,Middle East and Asia: Eastern Asia: China,1561,1268,293
E09000011,Greenwich,Middle East and Asia: Eastern Asia: Hong Kong (Special Administrative Region of China),167,54,113
E09000011,Greenwich,Middle East and Asia: Eastern Asia: Japan,241,225,16
E09000011,Greenwich,Middle East and Asia: Eastern Asia: Other Eastern Asia,193,125,68
E09000011,Greenwich,Middle East and Asia: Middle East: Iran,61,57,4
E09000011,Greenwich,Middle East and Asia: Middle East: Iraq,26,35,-9
E09000011,Greenwich,Middle East and Asia: Middle East: Other Middle East,199,101,98
E09000011,Greenwich,Middle East and Asia: South-East Asia: Malaysia,374,362,12
E09000011,Greenwich,Middle East and Asia: South-East Asia: Other South-East Asia,430,356,74
E09000011,Greenwich,Middle East and Asia: South-East Asia: Philippines,460,221,239
E09000011,Greenwich,Middle East and Asia: South-East Asia: Singapore,125,87,38
E09000011,Greenwich,Middle East and Asia: Southern Asia: Afghanistan,61,126,-65
E09000011,Greenwich,Middle East and Asia: Southern Asia: Bangladesh,290,320,-30
E09000011,Greenwich,Middle East and Asia: Southern Asia: India,2760,2093,667
E09000011,Greenwich,Middle East and Asia: Southern Asia: Other Southern Asia,3955,4747,-792
E09000011,Greenwich,Middle East and Asia: Southern Asia: Pakistan,550,498,52
E09000011,Greenwich,Middle East and Asia: Southern Asia: Sri Lanka,391,496,-105
E09000011,Greenwich,No passport held,24935,30894,-5959
E09000011,Greenwich,The Americas and the Caribbean: Central America,118,31,87
E09000011,Greenwich,The Americas and the Caribbean: North America: Canada,393,292,101
E09000011,Greenwich,The Americas and the Caribbean: North America: United States,1141,822,319
E09000011,Greenwich,The Americas and the Caribbean: South America,1364,623,741
E09000011,Greenwich,The Americas and the Caribbean: The Caribbean: Jamaica,464,561,-97
E09000011,Greenwich,The Americas and the Caribbean: The Caribbean: Other Caribbean,198,257,-59
E09000012,Hackney,Africa: Central and Western Africa: Ghana,1002,1651,-649
E09000012,Hackney,Africa: Central and Western Africa: Nigeria,1593,3079,-1486
E09000012,Hackney,Africa: Central and Western Africa: Other Central and Western Africa,608,1065,-457
E09000012,Hackney,Africa: North Africa,409,379,30
E09000012,Hackney,Africa: South and Eastern Africa: Kenya,43,80,-37
E09000012,Hackney,Africa: South and Eastern Africa: Other South and Eastern Africa,301,462,-161
E09000012,Hackney,Africa: South and Eastern Africa: Somalia,13,17,-4
E09000012,Hackney,Africa: South and Eastern Africa: South Africa,200,318,-118
E09000012,Hackney,Africa: South and Eastern Africa: Zimbabwe,54,190,-136
E09000012,Hackney,Antarctica and Oceania: Australasia: Australia,2050,1739,311
E09000012,Hackney,Antarctica and Oceania: Australasia: New Zealand,857,651,206
E09000012,Hackney,Antarctica and Oceania: Other Antarctica and Oceania,4,3,1
E09000012,Hackney,British Overseas Territories,1,31,-30
E09000012,Hackney,Europe: Ireland,4337,4398,-61
E09000012,Hackney,Europe: Other Europe: EU Member countries: France,4152,3104,1048
E09000012,Hackney,Europe: Other Europe: EU Member countries: Germany,1857,2171,-314
E09000012,Hackney,Europe: Other Europe: EU Member countries: Italy,5175,3033,2142
E09000012,Hackney,Europe: Other Europe: EU Member countries: Lithuania,569,521,48
E09000012,Hackney,Europe: Other Europe: EU Member countries: Other EU countries,7987,6029,1958
E09000012,Hackney,Europe: Other Europe: EU Member countries: Poland,3377,4330,-953
E09000012,Hackney,Europe: Other Europe: EU Member countries: Portugal,2915,1833,1082
E09000012,Hackney,Europe: Other Europe: EU Member countries: Romania,1134,431,703
E09000012,Hackney,Europe: Other Europe: EU Member countries: Spain,4082,1986,2096
E09000012,Hackney,Europe: Other Europe: Rest of Europe: Other Europe,1523,1206,317
E09000012,Hackney,Europe: Other Europe: Rest of Europe: Turkey,1650,1796,-146
E09000012,Hackney,Europe: United Kingdom,190520,177517,13003
E09000012,Hackney,Middle East and Asia: Central Asia,53,120,-67
E09000012,Hackney,Middle East and Asia: Eastern Asia: China,752,575,177
E09000012,Hackney,Middle East and Asia: Eastern Asia: Hong Kong (Special Administrative Region of China),87,54,33
E09000012,Hackney,Middle East and Asia: Eastern Asia: Japan,392,645,-253
E09000012,Hackney,Middle East and Asia: Eastern Asia: Other Eastern Asia,270,287,-17
E09000012,Hackney,Middle East and Asia: Middle East: Iran,50,66,-16
E09000012,Hackney,Middle East and Asia: Middle East: Iraq,30,34,-4
E09000012,Hackney,Middle East and Asia: Middle East: Other Middle East,715,627,88
E09000012,Hackney,Middle East and Asia: South-East Asia: Malaysia,200,291,-91
E09000012,Hackney,Middle East and Asia: South-East Asia: Other South-East Asia,251,337,-86
E09000012,Hackney,Middle East and Asia: South-East Asia: Philippines,171,153,18
E09000012,Hackney,Middle East and Asia: South-East Asia: Singapore,114,67,47
E09000012,Hackney,Middle East and Asia: Southern Asia: Afghanistan,45,86,-41
E09000012,Hackney,Middle East and Asia: Southern Asia: Bangladesh,479,487,-8
E09000012,Hackney,Middle East and Asia: Southern Asia: India,937,880,57
E09000012,Hackney,Middle East and Asia: Southern Asia: Other Southern Asia,13,36,-23
E09000012,Hackney,Middle East and Asia: Southern Asia: Pakistan,242,207,35
E09000012,Hackney,Middle East and Asia: Southern Asia: Sri Lanka,44,43,1
E09000012,Hackney,No passport held,11562,16734,-5172
E09000012,Hackney,The Americas and the Caribbean: Central America,151,122,29
E09000012,Hackney,The Americas and the Caribbean: North America: Canada,936,657,279
E09000012,Hackney,The Americas and the Caribbean: North America: United States,2498,2240,258
E09000012,Hackney,The Americas and the Caribbean: South America,1629,1751,-122
E09000012,Hackney,The Americas and the Caribbean: The Caribbean: Jamaica,782,1239,-457
E09000012,Hackney,The Americas and the Caribbean: The Caribbean: Other Caribbean,332,512,-180
E09000013,Hammersmith and Fulham,Africa: Central and Western Africa: Ghana,151,222,-71
E09000013,Hammersmith and Fulham,Africa: Central and Western Africa: Nigeria,280,370,-90
E09000013,Hammersmith and Fulham,Africa: Central and Western Africa: Other Central and Western Africa,121,172,-51
E09000013,Hammersmith and Fulham,Africa: North Africa,655,649,6
E09000013,Hammersmith and Fulham,Africa: South and Eastern Africa: Kenya,35,44,-9
E09000013,Hammersmith and Fulham,Africa: South and Eastern Africa: Other South and Eastern Africa,206,371,-165
E09000013,Hammersmith and Fulham,Africa: South and Eastern Africa: Somalia,19,24,-5
E09000013,Hammersmith and Fulham,Africa: South and Eastern Africa: South Africa,447,595,-148
E09000013,Hammersmith and Fulham,Africa: South and Eastern Africa: Zimbabwe,53,77,-24
E09000013,Hammersmith and Fulham,Antarctica and Oceania: Australasia: Australia,1501,3768,-2267
E09000013,Hammersmith and Fulham,Antarctica and Oceania: Australasia: New Zealand,538,1749,-1211
E09000013,Hammersmith and Fulham,Antarctica and Oceania: Other Antarctica and Oceania,12,5,7
E09000013,Hammersmith and Fulham,British Overseas Territories,3,9,-6
E09000013,Hammersmith and Fulham,Europe: Ireland,3818,5325,-1507
E09000013,Hammersmith and Fulham,Europe: Other Europe: EU Member countries: France,5387,5978,-591
E09000013,Hammersmith and Fulham,Europe: Other Europe: EU Member countries: Germany,1384,1537,-153
E09000013,Hammersmith and Fulham,Europe: Other Europe: EU Member countries: Italy,5972,3401,2571
E09000013,Hammersmith and Fulham,Europe: Other Europe: EU Member countries: Lithuania,564,373,191
E09000013,Hammersmith and Fulham,Europe: Other Europe: EU Member countries: Other EU countries,7156,5946,1210
E09000013,Hammersmith and Fulham,Europe: Other Europe: EU Member countries: Poland,2106,2782,-676
E09000013,Hammersmith and Fulham,Europe: Other Europe: EU Member countries: Portugal,2043,1621,422
E09000013,Hammersmith and Fulham,Europe: Other Europe: EU Member countries: Romania,1078,339,739
E09000013,Hammersmith and Fulham,Europe: Other Europe: EU Member countries: Spain,3883,2162,1721
E09000013,Hammersmith and Fulham,Europe: Other Europe: Rest of Europe: Other Europe,1916,1247,669
E09000013,Hammersmith and Fulham,Europe: Other Europe: Rest of Europe: Turkey,477,326,151
E09000013,Hammersmith and Fulham,Europe: United Kingdom,124799,122034,2765
E09000013,Hammersmith and Fulham,Middle East and Asia: Central Asia,75,166,-91
E09000013,Hammersmith and Fulham,Middle East and Asia: Eastern Asia: China,1451,724,727
E09000013,Hammersmith and Fulham,Middle East and Asia: Eastern Asia: Hong Kong (Special Administrative Region of China),238,60,178
E09000013,Hammersmith and Fulham,Middle East and Asia: Eastern Asia: Japan,485,518,-33
E09000013,Hammersmith and Fulham,Middle East and Asia: Eastern Asia: Other Eastern Asia,397,327,70
E09000013,Hammersmith and Fulham,Middle East and Asia: Middle East: Iran,222,337,-115
E09000013,Hammersmith and Fulham,Middle East and Asia: Middle East: Iraq,59,113,-54
E09000013,Hammersmith and Fulham,Middle East and Asia: Middle East: Other Middle East,544,551,-7
E09000013,Hammersmith and Fulham,Middle East and Asia: South-East Asia: Malaysia,396,492,-96
E09000013,Hammersmith and Fulham,Middle East and Asia: South-East Asia: Other South-East Asia,304,495,-191
E09000013,Hammersmith and Fulham,Middle East and Asia: South-East Asia: Philippines,1151,1121,30
E09000013,Hammersmith and Fulham,Middle East and Asia: South-East Asia: Singapore,178,189,-11
E09000013,Hammersmith and Fulham,Middle East and Asia: Southern Asia: Afghanistan,73,85,-12
E09000013,Hammersmith and Fulham,Middle East and Asia: Southern Asia: Bangladesh,122,86,36
E09000013,Hammersmith and Fulham,Middle East and Asia: Southern Asia: India,841,713,128
E09000013,Hammersmith and Fulham,Middle East and Asia: Southern Asia: Other Southern Asia,26,65,-39
E09000013,Hammersmith and Fulham,Middle East and Asia: Southern Asia: Pakistan,217,211,6
E09000013,Hammersmith and Fulham,Middle East and Asia: Southern Asia: Sri Lanka,49,82,-33
E09000013,Hammersmith and Fulham,No passport held,7088,10093,-3005
E09000013,Hammersmith and Fulham,The Americas and the Caribbean: Central America,167,206,-39
E09000013,Hammersmith and Fulham,The Americas and the Caribbean: North America: Canada,686,739,-53
E09000013,Hammersmith and Fulham,The Americas and the Caribbean: North America: United States,2037,2037,0
E09000013,Hammersmith and Fulham,The Americas and the Caribbean: South America,1397,1420,-23
E09000013,Hammersmith and Fulham,The Americas and the Caribbean: The Caribbean: Jamaica,142,211,-69
E09000013,Hammersmith and Fulham,The Americas and the Caribbean: The Caribbean: Other Caribbean,208,326,-118
E09000014,Haringey,Africa: Central and Western Africa: Ghana,1026,1606,-580
E09000014,Haringey,Africa: Central and Western Africa: Nigeria,767,1330,-563
E09000014,Haringey,Africa: Central and Western Africa: Other Central and Western Africa,423,611,-188
E09000014,Haringey,Africa: North Africa,466,462,4
E09000014,Haringey,Africa: South and Eastern Africa: Kenya,59,76,-17
E09000014,Haringey,Africa: South and Eastern Africa: Other South and Eastern Africa,543,1102,-559
E09000014,Haringey,Africa: South and Eastern Africa: Somalia,50,39,11
E09000014,Haringey,Africa: South and Eastern Africa: South Africa,186,431,-245
E09000014,Haringey,Africa: South and Eastern Africa: Zimbabwe,74,156,-82
E09000014,Haringey,Antarctica and Oceania: Australasia: Australia,743,1099,-356
E09000014,Haringey,Antarctica and Oceania: Australasia: New Zealand,253,468,-215
E09000014,Haringey,Antarctica and Oceania: Other Antarctica and Oceania,6,7,-1
E09000014,Haringey,British Overseas Territories,5,11,-6
E09000014,Haringey,Europe: Ireland,4206,5464,-1258
E09000014,Haringey,Europe: Other Europe: EU Member countries: France,2435,2559,-124
E09000014,Haringey,Europe: Other Europe: EU Member countries: Germany,1273,1805,-532
E09000014,Haringey,Europe: Other Europe: EU Member countries: Italy,6542,3506,3036
E09000014,Haringey,Europe: Other Europe: EU Member countries: Lithuania,1059,1065,-6
E09000014,Haringey,Europe: Other Europe: EU Member countries: Other EU countries,15687,10487,5200
E09000014,Haringey,Europe: Other Europe: EU Member countries: Poland,7496,10995,-3499
E09000014,Haringey,Europe: Other Europe: EU Member countries: Portugal,2804,2059,745
E09000014,Haringey,Europe: Other Europe: EU Member countries: Romania,6286,2264,4022
E09000014,Haringey,Europe: Other Europe: EU Member countries: Spain,6360,2136,4224
E09000014,Haringey,Europe: Other Europe: Rest of Europe: Other Europe,2370,1325,1045
E09000014,Haringey,Europe: Other Europe: Rest of Europe: Turkey,1806,1868,-62
E09000014,Haringey,Europe: United Kingdom,180026,174726,5300
E09000014,Haringey,Middle East and Asia: Central Asia,70,160,-90
E09000014,Haringey,Middle East and Asia: Eastern Asia: China,700,845,-145
E09000014,Haringey,Middle East and Asia: Eastern Asia: Hong Kong (Special Administrative Region of China),60,36,24
E09000014,Haringey,Middle East and Asia: Eastern Asia: Japan,336,623,-287
E09000014,Haringey,Middle East and Asia: Eastern Asia: Other Eastern Asia,157,133,24
E09000014,Haringey,Middle East and Asia: Middle East: Iran,117,222,-105
E09000014,Haringey,Middle East and Asia: Middle East: Iraq,24,43,-19
E09000014,Haringey,Middle East and Asia: Middle East: Other Middle East,416,336,80
E09000014,Haringey,Middle East and Asia: South-East Asia: Malaysia,234,365,-131
E09000014,Haringey,Middle East and Asia: South-East Asia: Other South-East Asia,181,262,-81
E09000014,Haringey,Middle East and Asia: South-East Asia: Philippines,343,448,-105
E09000014,Haringey,Middle East and Asia: South-East Asia: Singapore,69,64,5
E09000014,Haringey,Middle East and Asia: Southern Asia: Afghanistan,62,102,-40
E09000014,Haringey,Middle East and Asia: Southern Asia: Bangladesh,312,547,-235
E09000014,Haringey,Middle East and Asia: Southern Asia: India,721,942,-221
E09000014,Haringey,Middle East and Asia: Southern Asia: Other Southern Asia,71,95,-24
E09000014,Haringey,Middle East and Asia: Southern Asia: Pakistan,229,312,-83
E09000014,Haringey,Middle East and Asia: Southern Asia: Sri Lanka,106,146,-40
E09000014,Haringey,No passport held,11334,15775,-4441
E09000014,Haringey,The Americas and the Caribbean: Central America,184,113,71
E09000014,Haringey,The Americas and the Caribbean: North America: Canada,425,437,-12
E09000014,Haringey,The Americas and the Caribbean: North America: United States,1257,1400,-143
E09000014,Haringey,The Americas and the Caribbean: South America,2758,2056,702
E09000014,Haringey,The Americas and the Caribbean: The Caribbean: Jamaica,776,1458,-682
E09000014,Haringey,The Americas and the Caribbean: The Caribbean: Other Caribbean,347,349,-2
E09000015,Harrow,Africa: Central and Western Africa: Ghana,285,401,-116
E09000015,Harrow,Africa: Central and Western Africa: Nigeria,405,555,-150
E09000015,Harrow,Africa: Central and Western Africa: Other Central and Western Africa,96,150,-54
E09000015,Harrow,Africa: North Africa,373,205,168
E09000015,Harrow,Africa: South and Eastern Africa: Kenya,311,839,-528
E09000015,Harrow,Africa: South and Eastern Africa: Other South and Eastern Africa,278,508,-230
E09000015,Harrow,Africa: South and Eastern Africa: Somalia,23,32,-9
E09000015,Harrow,Africa: South and Eastern Africa: South Africa,106,309,-203
E09000015,Harrow,Africa: South and Eastern Africa: Zimbabwe,53,173,-120
E09000015,Harrow,Antarctica and Oceania: Australasia: Australia,177,224,-47
E09000015,Harrow,Antarctica and Oceania: Australasia: New Zealand,66,142,-76
E09000015,Harrow,Antarctica and Oceania: Other Antarctica and Oceania,17,16,1
E09000015,Harrow,British Overseas Territories,8,10,-2
E09000015,Harrow,Europe: Ireland,4126,5949,-1823
E09000015,Harrow,Europe: Other Europe: EU Member countries: France,1536,1701,-165
E09000015,Harrow,Europe: Other Europe: EU Member countries: Germany,1374,1679,-305
E09000015,Harrow,Europe: Other Europe: EU Member countries: Italy,1806,833,973
E09000015,Harrow,Europe: Other Europe: EU Member countries: Lithuania,525,590,-65
E09000015,Harrow,Europe: Other Europe: EU Member countries: Other EU countries,6333,4591,1742
E09000015,Harrow,Europe: Other Europe: EU Member countries: Poland,3788,3887,-99
E09000015,Harrow,Europe: Other Europe: EU Member countries: Portugal,2061,1193,868
E09000015,Harrow,Europe: Other Europe: EU Member countries: Romania,22026,4819,17207
E09000015,Harrow,Europe: Other Europe: EU Member countries: Spain,898,445,453
E09000015,Harrow,Europe: Other Europe: Rest of Europe: Other Europe,1115,767,348
E09000015,Harrow,Europe: Other Europe: Rest of Europe: Turkey,179,118,61
E09000015,Harrow,Europe: United Kingdom,184196,178396,5800
E09000015,Harrow,Middle East and Asia: Central Asia,23,11,12
E09000015,Harrow,Middle East and Asia: Eastern Asia: China,387,213,174
E09000015,Harrow,Middle East and Asia: Eastern Asia: Hong Kong (Special Administrative Region of China),78,40,38
E09000015,Harrow,Middle East and Asia: Eastern Asia: Japan,199,226,-27
E09000015,Harrow,Middle East and Asia: Eastern Asia: Other Eastern Asia,68,99,-31
E09000015,Harrow,Middle East and Asia: Middle East: Iran,176,199,-23
E09000015,Harrow,Middle East and Asia: Middle East: Iraq,84,86,-2
E09000015,Harrow,Middle East and Asia: Middle East: Other Middle East,253,167,86
E09000015,Harrow,Middle East and Asia: South-East Asia: Malaysia,292,381,-89
E09000015,Harrow,Middle East and Asia: South-East Asia: Other South-East Asia,153,115,38
E09000015,Harrow,Middle East and Asia: South-East Asia: Philippines,488,414,74
E09000015,Harrow,Middle East and Asia: South-East Asia: Singapore,47,64,-17
E09000015,Harrow,Middle East and Asia: Southern Asia: Afghanistan,854,701,153
E09000015,Harrow,Middle East and Asia: Southern Asia: Bangladesh,130,124,6
E09000015,Harrow,Middle East and Asia: Southern Asia: India,9095,8211,884
E09000015,Harrow,Middle East and Asia: Southern Asia: Other Southern Asia,891,1180,-289
E09000015,Harrow,Middle East and Asia: Southern Asia: Pakistan,979,1179,-200
E09000015,Harrow,Middle East and Asia: Southern Asia: Sri Lanka,2159,2979,-820
E09000015,Harrow,No passport held,11134,12700,-1566
E09000015,Harrow,The Americas and the Caribbean: Central America,24,29,-5
E09000015,Harrow,The Americas and the Caribbean: North America: Canada,216,208,8
E09000015,Harrow,The Americas and the Caribbean: North America: United States,450,467,-17
E09000015,Harrow,The Americas and the Caribbean: South America,509,283,226
E09000015,Harrow,The Americas and the Caribbean: The Caribbean: Jamaica,238,303,-65
E09000015,Harrow,The Americas and the Caribbean: The Caribbean: Other Caribbean,115,145,-30
E09000016,Havering,Africa: Central and Western Africa: Ghana,398,317,81
E09000016,Havering,Africa: Central and Western Africa: Nigeria,1307,1070,237
E09000016,Havering,Africa: Central and Western Africa: Other Central and Western Africa,125,114,11
E09000016,Havering,Africa: North Africa,173,80,93
E09000016,Havering,Africa: South and Eastern Africa: Kenya,65,69,-4
E09000016,Havering,Africa: South and Eastern Africa: Other South and Eastern Africa,266,245,21
E09000016,Havering,Africa: South and Eastern Africa: Somalia,0,0,0
E09000016,Havering,Africa: South and Eastern Africa: South Africa,160,232,-72
E09000016,Havering,Africa: South and Eastern Africa: Zimbabwe,196,353,-157
E09000016,Havering,Antarctica and Oceania: Australasia: Australia,103,96,7
E09000016,Havering,Antarctica and Oceania: Australasia: New Zealand,42,78,-36
E09000016,Havering,Antarctica and Oceania: Other Antarctica and Oceania,2,1,1
E09000016,Havering,British Overseas Territories,4,2,2
E09000016,Havering,Europe: Ireland,2363,2229,134
E09000016,Havering,Europe: Other Europe: EU Member countries: France,472,301,171
E09000016,Havering,Europe: Other Europe: EU Member countries: Germany,369,230,139
E09000016,Havering,Europe: Other Europe: EU Member countries: Italy,1054,283,771
E09000016,Havering,Europe: Other Europe: EU Member countries: Lithuania,3427,1275,2152
E09000016,Havering,Europe: Other Europe: EU Member countries: Other EU countries,3517,1216,2301
E09000016,Havering,Europe: Other Europe: EU Member countries: Poland,1891,917,974
E09000016,Havering,Europe: Other Europe: EU Member countries: Portugal,899,252,647
E09000016,Havering,Europe: Other Europe: EU Member countries: Romania,6707,461,6246
E09000016,Havering,Europe: Other Europe: EU Member countries: Spain,658,178,480
E09000016,Havering,Europe: Other Europe: Rest of Europe: Other Europe,1067,236,831
E09000016,Havering,Europe: Other Europe: Rest of Europe: Turkey,201,133,68
E09000016,Havering,Europe: United Kingdom,207774,194839,12935
E09000016,Havering,Middle East and Asia: Central Asia,29,4,25
E09000016,Havering,Middle East and Asia: Eastern Asia: China,262,143,119
E09000016,Havering,Middle East and Asia: Eastern Asia: Hong Kong (Special Administrative Region of China),27,12,15
E09000016,Havering,Middle East and Asia: Eastern Asia: Japan,44,33,11
E09000016,Havering,Middle East and Asia: Eastern Asia: Other Eastern Asia,46,25,21
E09000016,Havering,Middle East and Asia: Middle East: Iran,42,21,21
E09000016,Havering,Middle East and Asia: Middle East: Iraq,21,6,15
E09000016,Havering,Middle East and Asia: Middle East: Other Middle East,67,12,55
E09000016,Havering,Middle East and Asia: South-East Asia: Malaysia,128,154,-26
E09000016,Havering,Middle East and Asia: South-East Asia: Other South-East Asia,174,141,33
E09000016,Havering,Middle East and Asia: South-East Asia: Philippines,367,340,27
E09000016,Havering,Middle East and Asia: South-East Asia: Singapore,15,15,0
E09000016,Havering,Middle East and Asia: Southern Asia: Afghanistan,42,8,34
E09000016,Havering,Middle East and Asia: Southern Asia: Bangladesh,417,165,252
E09000016,Havering,Middle East and Asia: Southern Asia: India,1512,853,659
E09000016,Havering,Middle East and Asia: Southern Asia: Other Southern Asia,60,32,28
E09000016,Havering,Middle East and Asia: Southern Asia: Pakistan,838,222,616
E09000016,Havering,Middle East and Asia: Southern Asia: Sri Lanka,158,178,-20
E09000016,Havering,No passport held,23787,29124,-5337
E09000016,Havering,The Americas and the Caribbean: Central America,20,6,14
E09000016,Havering,The Americas and the Caribbean: North America: Canada,94,87,7
E09000016,Havering,The Americas and the Caribbean: North America: United States,156,144,12
E09000016,Havering,The Americas and the Caribbean: South America,238,89,149
E09000016,Havering,The Americas and the Caribbean: The Caribbean: Jamaica,140,87,53
E09000016,Havering,The Americas and the Caribbean: The Caribbean: Other Caribbean,128,124,4
E09000017,Hillingdon,Africa: Central and Western Africa: Ghana,267,262,5
E09000017,Hillingdon,Africa: Central and Western Africa: Nigeria,506,809,-303
E09000017,Hillingdon,Africa: Central and Western Africa: Other Central and Western Africa,143,190,-47
E09000017,Hillingdon,Africa: North Africa,432,307,125
E09000017,Hillingdon,Africa: South and Eastern Africa: Kenya,186,310,-124
E09000017,Hillingdon,Africa: South and Eastern Africa: Other South and Eastern Africa,511,718,-207
E09000017,Hillingdon,Africa: South and Eastern Africa: Somalia,69,26,43
E09000017,Hillingdon,Africa: South and Eastern Africa: South Africa,223,423,-200
E09000017,Hillingdon,Africa: South and Eastern Africa: Zimbabwe,155,454,-299
E09000017,Hillingdon,Antarctica and Oceania: Australasia: Australia,209,255,-46
E09000017,Hillingdon,Antarctica and Oceania: Australasia: New Zealand,103,180,-77
E09000017,Hillingdon,Antarctica and Oceania: Other Antarctica and Oceania,20,18,2
E09000017,Hillingdon,British Overseas Territories,0,9,-9
E09000017,Hillingdon,Europe: Ireland,4244,4585,-341
E09000017,Hillingdon,Europe: Other Europe: EU Member countries: France,1203,985,218
E09000017,Hillingdon,Europe: Other Europe: EU Member countries: Germany,1394,1292,102
E09000017,Hillingdon,Europe: Other Europe: EU Member countries: Italy,2813,888,1925
E09000017,Hillingdon,Europe: Other Europe: EU Member countries: Lithuania,1267,1005,262
E09000017,Hillingdon,Europe: Other Europe: EU Member countries: Other EU countries,6757,4589,2168
E09000017,Hillingdon,Europe: Other Europe: EU Member countries: Poland,6397,4329,2068
E09000017,Hillingdon,Europe: Other Europe: EU Member countries: Portugal,5474,1558,3916
E09000017,Hillingdon,Europe: Other Europe: EU Member countries: Romania,6382,779,5603
E09000017,Hillingdon,Europe: Other Europe: EU Member countries: Spain,1172,608,564
E09000017,Hillingdon,Europe: Other Europe: Rest of Europe: Other Europe,1310,853,457
E09000017,Hillingdon,Europe: Other Europe: Rest of Europe: Turkey,285,164,121
E09000017,Hillingdon,Europe: United Kingdom,221038,204579,16459
E09000017,Hillingdon,Middle East and Asia: Central Asia,61,27,34
E09000017,Hillingdon,Middle East and Asia: Eastern Asia: China,653,688,-35
E09000017,Hillingdon,Middle East and Asia: Eastern Asia: Hong Kong (Special Administrative Region of China),128,63,65
E09000017,Hillingdon,Middle East and Asia: Eastern Asia: Japan,170,183,-13
E09000017,Hillingdon,Middle East and Asia: Eastern Asia: Other Eastern Asia,91,181,-90
E09000017,Hillingdon,Middle East and Asia: Middle East: Iran,145,268,-123
E09000017,Hillingdon,Middle East and Asia: Middle East: Iraq,88,107,-19
E09000017,Hillingdon,Middle East and Asia: Middle East: Other Middle East,375,584,-209
E09000017,Hillingdon,Middle East and Asia: South-East Asia: Malaysia,291,364,-73
E09000017,Hillingdon,Middle East and Asia: South-East Asia: Other South-East Asia,233,356,-123
E09000017,Hillingdon,Middle East and Asia: South-East Asia: Philippines,430,485,-55
E09000017,Hillingdon,Middle East and Asia: South-East Asia: Singapore,61,90,-29
E09000017,Hillingdon,Middle East and Asia: Southern Asia: Afghanistan,706,590,116
E09000017,Hillingdon,Middle East and Asia: Southern Asia: Bangladesh,466,325,141
E09000017,Hillingdon,Middle East and Asia: Southern Asia: India,11795,6768,5027
E09000017,Hillingdon,Middle East and Asia: Southern Asia: Other Southern Asia,1165,1363,-198
E09000017,Hillingdon,Middle East and Asia: Southern Asia: Pakistan,1959,2197,-238
E09000017,Hillingdon,Middle East and Asia: Southern Asia: Sri Lanka,1256,1483,-227
E09000017,Hillingdon,No passport held,21482,25979,-4497
E09000017,Hillingdon,The Americas and the Caribbean: Central America,48,51,-3
E09000017,Hillingdon,The Americas and the Caribbean: North America: Canada,242,280,-38
E09000017,Hillingdon,The Americas and the Caribbean: North America: United States,526,590,-64
E09000017,Hillingdon,The Americas and the Caribbean: South America,542,311,231
E09000017,Hillingdon,The Americas and the Caribbean: The Caribbean: Jamaica,242,209,33
E09000017,Hillingdon,The Americas and the Caribbean: The Caribbean: Other Caribbean,193,219,-26
E09000018,Hounslow,Africa: Central and Western Africa: Ghana,344,521,-177
E09000018,Hounslow,Africa: Central and Western Africa: Nigeria,405,564,-159
E09000018,Hounslow,Africa: Central and Western Africa: Other Central and Western Africa,156,229,-73
E09000018,Hounslow,Africa: North Africa,1002,498,504
E09000018,Hounslow,Africa: South and Eastern Africa: Kenya,159,310,-151
E09000018,Hounslow,Africa: South and Eastern Africa: Other South and Eastern Africa,427,755,-328
E09000018,Hounslow,Africa: South and Eastern Africa: Somalia,50,38,12
E09000018,Hounslow,Africa: South and Eastern Africa: South Africa,251,531,-280
E09000018,Hounslow,Africa: South and Eastern Africa: Zimbabwe,143,316,-173
E09000018,Hounslow,Antarctica and Oceania: Australasia: Australia,459,715,-256
E09000018,Hounslow,Antarctica and Oceania: Australasia: New Zealand,192,480,-288
E09000018,Hounslow,Antarctica and Oceania: Other Antarctica and Oceania,46,11,35
E09000018,Hounslow,British Overseas Territories,1,17,-16
E09000018,Hounslow,Europe: Ireland,3196,3962,-766
E09000018,Hounslow,Europe: Other Europe: EU Member countries: France,1715,1674,41
E09000018,Hounslow,Europe: Other Europe: EU Member countries: Germany,1095,1166,-71
E09000018,Hounslow,Europe: Other Europe: EU Member countries: Italy,3395,1425,1970
E09000018,Hounslow,Europe: Other Europe: EU Member countries: Lithuania,1655,1247,408
E09000018,Hounslow,Europe: Other Europe: EU Member countries: Other EU countries,8278,5414,2864
E09000018,Hounslow,Europe: Other Europe: EU Member countries: Poland,11223,10414,809
E09000018,Hounslow,Europe: Other Europe: EU Member countries: Portugal,10537,2368,8169
E09000018,Hounslow,Europe: Other Europe: EU Member countries: Romania,6577,765,5812
E09000018,Hounslow,Europe: Other Europe: EU Member countries: Spain,2059,1047,1012
E09000018,Hounslow,Europe: Other Europe: Rest of Europe: Other Europe,2064,995,1069
E09000018,Hounslow,Europe: Other Europe: Rest of Europe: Turkey,447,164,283
E09000018,Hounslow,Europe: United Kingdom,186843,170386,16457
E09000018,Hounslow,Middle East and Asia: Central Asia,62,66,-4
E09000018,Hounslow,Middle East and Asia: Eastern Asia: China,455,377,78
E09000018,Hounslow,Middle East and Asia: Eastern Asia: Hong Kong (Special Administrative Region of China),46,21,25
E09000018,Hounslow,Middle East and Asia: Eastern Asia: Japan,327,305,22
E09000018,Hounslow,Middle East and Asia: Eastern Asia: Other Eastern Asia,154,128,26
E09000018,Hounslow,Middle East and Asia: Middle East: Iran,213,213,0
E09000018,Hounslow,Middle East and Asia: Middle East: Iraq,63,67,-4
E09000018,Hounslow,Middle East and Asia: Middle East: Other Middle East,417,285,132
E09000018,Hounslow,Middle East and Asia: South-East Asia: Malaysia,252,329,-77
E09000018,Hounslow,Middle East and Asia: South-East Asia: Other South-East Asia,312,557,-245
E09000018,Hounslow,Middle East and Asia: South-East Asia: Philippines,814,824,-10
E09000018,Hounslow,Middle East and Asia: South-East Asia: Singapore,69,100,-31
E09000018,Hounslow,Middle East and Asia: Southern Asia: Afghanistan,562,810,-248
E09000018,Hounslow,Middle East and Asia: Southern Asia: Bangladesh,350,405,-55
E09000018,Hounslow,Middle East and Asia: Southern Asia: India,16027,14537,1490
E09000018,Hounslow,Middle East and Asia: Southern Asia: Other Southern Asia,2406,2109,297
E09000018,Hounslow,Middle East and Asia: Southern Asia: Pakistan,2053,2666,-613
E09000018,Hounslow,Middle East and Asia: Southern Asia: Sri Lanka,636,1266,-630
E09000018,Hounslow,No passport held,17792,20703,-2911
E09000018,Hounslow,The Americas and the Caribbean: Central America,75,54,21
E09000018,Hounslow,The Americas and the Caribbean: North America: Canada,296,312,-16
E09000018,Hounslow,The Americas and the Caribbean: North America: United States,913,852,61
E09000018,Hounslow,The Americas and the Caribbean: South America,861,582,279
E09000018,Hounslow,The Americas and the Caribbean: The Caribbean: Jamaica,164,205,-41
E09000018,Hounslow,The Americas and the Caribbean: The Caribbean: Other Caribbean,145,172,-27
E09000019,Islington,Africa: Central and Western Africa: Ghana,212,270,-58
E09000019,Islington,Africa: Central and Western Africa: Nigeria,405,561,-156
E09000019,Islington,Africa: Central and Western Africa: Other Central and Western Africa,187,248,-61
E09000019,Islington,Africa: North Africa,466,364,102
E09000019,Islington,Africa: South and Eastern Africa: Kenya,52,77,-25
E09000019,Islington,Africa: South and Eastern Africa: Other South and Eastern Africa,249,380,-131
E09000019,Islington,Africa: South and Eastern Africa: Somalia,58,33,25
E09000019,Islington,Africa: South and Eastern Africa: South Africa,235,311,-76
E09000019,Islington,Africa: South and Eastern Africa: Zimbabwe,44,64,-20
E09000019,Islington,Antarctica and Oceania: Australasia: Australia,2381,2367,14
E09000019,Islington,Antarctica and Oceania: Australasia: New Zealand,788,765,23
E09000019,Islington,Antarctica and Oceania: Other Antarctica and Oceania,2,4,-2
E09000019,Islington,British Overseas Territories,6,23,-17
E09000019,Islington,Europe: Ireland,5092,6336,-1244
E09000019,Islington,Europe: Other Europe: EU Member countries: France,4571,2984,1587
E09000019,Islington,Europe: Other Europe: EU Member countries: Germany,1633,1920,-287
E09000019,Islington,Europe: Other Europe: EU Member countries: Italy,5444,3346,2098
E09000019,Islington,Europe: Other Europe: EU Member countries: Lithuania,427,234,193
E09000019,Islington,Europe: Other Europe: EU Member countries: Other EU countries,7387,5614,1773
E09000019,Islington,Europe: Other Europe: EU Member countries: Poland,1583,1611,-28
E09000019,Islington,Europe: Other Europe: EU Member countries: Portugal,1695,1294,401
E09000019,Islington,Europe: Other Europe: EU Member countries: Romania,1049,267,782
E09000019,Islington,Europe: Other Europe: EU Member countries: Spain,3487,1834,1653
E09000019,Islington,Europe: Other Europe: Rest of Europe: Other Europe,1884,1402,482
E09000019,Islington,Europe: Other Europe: Rest of Europe: Turkey,994,807,187
E09000019,Islington,Europe: United Kingdom,153742,147787,5955
E09000019,Islington,Middle East and Asia: Central Asia,72,107,-35
E09000019,Islington,Middle East and Asia: Eastern Asia: China,1458,988,470
E09000019,Islington,Middle East and Asia: Eastern Asia: Hong Kong (Special Administrative Region of China),193,84,109
E09000019,Islington,Middle East and Asia: Eastern Asia: Japan,450,657,-207
E09000019,Islington,Middle East and Asia: Eastern Asia: Other Eastern Asia,422,353,69
E09000019,Islington,Middle East and Asia: Middle East: Iran,112,147,-35
E09000019,Islington,Middle East and Asia: Middle East: Iraq,36,23,13
E09000019,Islington,Middle East and Asia: Middle East: Other Middle East,339,328,11
E09000019,Islington,Middle East and Asia: South-East Asia: Malaysia,453,504,-51
E09000019,Islington,Middle East and Asia: South-East Asia: Other South-East Asia,257,313,-56
E09000019,Islington,Middle East and Asia: South-East Asia: Philippines,274,279,-5
E09000019,Islington,Middle East and Asia: South-East Asia: Singapore,231,201,30
E09000019,Islington,Middle East and Asia: Southern Asia: Afghanistan,36,40,-4
E09000019,Islington,Middle East and Asia: Southern Asia: Bangladesh,340,345,-5
E09000019,Islington,Middle East and Asia: Southern Asia: India,1045,696,349
E09000019,Islington,Middle East and Asia: Southern Asia: Other Southern Asia,33,79,-46
E09000019,Islington,Middle East and Asia: Southern Asia: Pakistan,159,206,-47
E09000019,Islington,Middle East and Asia: Southern Asia: Sri Lanka,34,72,-38
E09000019,Islington,No passport held,10757,14542,-3785
E09000019,Islington,The Americas and the Caribbean: Central America,167,141,26
E09000019,Islington,The Americas and the Caribbean: North America: Canada,950,826,124
E09000019,Islington,The Americas and the Caribbean: North America: United States,2820,2486,334
E09000019,Islington,The Americas and the Caribbean: South America,1518,1268,250
E09000019,Islington,The Americas and the Caribbean: The Caribbean: Jamaica,219,318,-99
E09000019,Islington,The Americas and the Caribbean: The Caribbean: Other Caribbean,137,219,-82
E09000020,Kensington and Chelsea,Africa: Central and Western Africa: Ghana,84,72,12
E09000020,Kensington and Chelsea,Africa: Central and Western Africa: Nigeria,157,200,-43
E09000020,Kensington and Chelsea,Africa: Central and Western Africa: Other Central and Western Africa,67,126,-59
E09000020,Kensington and Chelsea,Africa: North Africa,628,688,-60
E09000020,Kensington and Chelsea,Africa: South and Eastern Africa: Kenya,34,67,-33
E09000020,Kensington and Chelsea,Africa: South and Eastern Africa: Other South and Eastern Africa,131,239,-108
E09000020,Kensington and Chelsea,Africa: South and Eastern Africa: Somalia,10,7,3
E09000020,Kensington and Chelsea,Africa: South and Eastern Africa: South Africa,251,316,-65
E09000020,Kensington and Chelsea,Africa: South and Eastern Africa: Zimbabwe,22,35,-13
E09000020,Kensington and Chelsea,Antarctica and Oceania: Australasia: Australia,1108,2064,-956
E09000020,Kensington and Chelsea,Antarctica and Oceania: Australasia: New Zealand,196,523,-327
E09000020,Kensington and Chelsea,Antarctica and Oceania: Other Antarctica and Oceania,3,11,-8
E09000020,Kensington and Chelsea,British Overseas Territories,0,24,-24
E09000020,Kensington and Chelsea,Europe: Ireland,2203,3259,-1056
E09000020,Kensington and Chelsea,Europe: Other Europe: EU Member countries: France,5632,8118,-2486
E09000020,Kensington and Chelsea,Europe: Other Europe: EU Member countries: Germany,1823,2776,-953
E09000020,Kensington and Chelsea,Europe: Other Europe: EU Member countries: Italy,5456,5105,351
E09000020,Kensington and Chelsea,Europe: Other Europe: EU Member countries: Lithuania,304,219,85
E09000020,Kensington and Chelsea,Europe: Other Europe: EU Member countries: Other EU countries,6507,7650,-1143
E09000020,Kensington and Chelsea,Europe: Other Europe: EU Member countries: Poland,824,938,-114
E09000020,Kensington and Chelsea,Europe: Other Europe: EU Member countries: Portugal,1590,1705,-115
E09000020,Kensington and Chelsea,Europe: Other Europe: EU Member countries: Romania,678,199,479
E09000020,Kensington and Chelsea,Europe: Other Europe: EU Member countries: Spain,3246,3196,50
E09000020,Kensington and Chelsea,Europe: Other Europe: Rest of Europe: Other Europe,2398,2454,-56
E09000020,Kensington and Chelsea,Europe: Other Europe: Rest of Europe: Turkey,636,425,211
E09000020,Kensington and Chelsea,Europe: United Kingdom,92446,95979,-3533
E09000020,Kensington and Chelsea,Middle East and Asia: Central Asia,112,165,-53
E09000020,Kensington and Chelsea,Middle East and Asia: Eastern Asia: China,1417,887,530
E09000020,Kensington and Chelsea,Middle East and Asia: Eastern Asia: Hong Kong (Special Administrative Region of China),227,82,145
E09000020,Kensington and Chelsea,Middle East and Asia: Eastern Asia: Japan,782,1023,-241
E09000020,Kensington and Chelsea,Middle East and Asia: Eastern Asia: Other Eastern Asia,292,288,4
E09000020,Kensington and Chelsea,Middle East and Asia: Middle East: Iran,207,434,-227
E09000020,Kensington and Chelsea,Middle East and Asia: Middle East: Iraq,56,133,-77
E09000020,Kensington and Chelsea,Middle East and Asia: Middle East: Other Middle East,832,956,-124
E09000020,Kensington and Chelsea,Middle East and Asia: South-East Asia: Malaysia,463,600,-137
E09000020,Kensington and Chelsea,Middle East and Asia: South-East Asia: Other South-East Asia,375,652,-277
E09000020,Kensington and Chelsea,Middle East and Asia: South-East Asia: Philippines,760,1172,-412
E09000020,Kensington and Chelsea,Middle East and Asia: South-East Asia: Singapore,258,481,-223
E09000020,Kensington and Chelsea,Middle East and Asia: Southern Asia: Afghanistan,17,27,-10
E09000020,Kensington and Chelsea,Middle East and Asia: Southern Asia: Bangladesh,67,93,-26
E09000020,Kensington and Chelsea,Middle East and Asia: Southern Asia: India,704,563,141
E09000020,Kensington and Chelsea,Middle East and Asia: Southern Asia: Other Southern Asia,35,88,-53
E09000020,Kensington and Chelsea,Middle East and Asia: Southern Asia: Pakistan,202,152,50
E09000020,Kensington and Chelsea,Middle East and Asia: Southern Asia: Sri Lanka,64,88,-24
E09000020,Kensington and Chelsea,No passport held,3908,5040,-1132
E09000020,Kensington and Chelsea,The Americas and the Caribbean: Central America,144,233,-89
E09000020,Kensington and Chelsea,The Americas and the Caribbean: North America: Canada,837,1174,-337
E09000020,Kensington and Chelsea,The Americas and the Caribbean: North America: United States,3869,6489,-2620
E09000020,Kensington and Chelsea,The Americas and the Caribbean: South America,1102,1207,-105
E09000020,Kensington and Chelsea,The Americas and the Caribbean: The Caribbean: Jamaica,53,76,-23
E09000020,Kensington and Chelsea,The Americas and the Caribbean: The Caribbean: Other Caribbean,158,151,7
E09000021,Kingston upon Thames,Africa: Central and Western Africa: Ghana,74,95,-21
E09000021,Kingston upon Thames,Africa: Central and Western Africa: Nigeria,146,195,-49
E09000021,Kingston upon Thames,Africa: Central and Western Africa: Other Central and Western Africa,68,75,-7
E09000021,Kingston upon Thames,Africa: North Africa,322,192,130
E09000021,Kingston upon Thames,Africa: South and Eastern Africa: Kenya,42,78,-36
E09000021,Kingston upon Thames,Africa: South and Eastern Africa: Other South and Eastern Africa,175,283,-108
E09000021,Kingston upon Thames,Africa: South and Eastern Africa: Somalia,1,0,1
E09000021,Kingston upon Thames,Africa: South and Eastern Africa: South Africa,478,686,-208
E09000021,Kingston upon Thames,Africa: South and Eastern Africa: Zimbabwe,84,189,-105
E09000021,Kingston upon Thames,Antarctica and Oceania: Australasia: Australia,355,451,-96
E09000021,Kingston upon Thames,Antarctica and Oceania: Australasia: New Zealand,159,219,-60
E09000021,Kingston upon Thames,Antarctica and Oceania: Other Antarctica and Oceania,1,19,-18
E09000021,Kingston upon Thames,British Overseas Territories,5,7,-2
E09000021,Kingston upon Thames,Europe: Ireland,2000,2153,-153
E09000021,Kingston upon Thames,Europe: Other Europe: EU Member countries: France,1166,1138,28
E09000021,Kingston upon Thames,Europe: Other Europe: EU Member countries: Germany,1563,1928,-365
E09000021,Kingston upon Thames,Europe: Other Europe: EU Member countries: Italy,2073,1125,948
E09000021,Kingston upon Thames,Europe: Other Europe: EU Member countries: Lithuania,630,422,208
E09000021,Kingston upon Thames,Europe: Other Europe: EU Member countries: Other EU countries,5366,3525,1841
E09000021,Kingston upon Thames,Europe: Other Europe: EU Member countries: Poland,2372,2078,294
E09000021,Kingston upon Thames,Europe: Other Europe: EU Member countries: Portugal,1282,739,543
E09000021,Kingston upon Thames,Europe: Other Europe: EU Member countries: Romania,1190,214,976
E09000021,Kingston upon Thames,Europe: Other Europe: EU Member countries: Spain,1098,553,545
E09000021,Kingston upon Thames,Europe: Other Europe: Rest of Europe: Other Europe,1083,798,285
E09000021,Kingston upon Thames,Europe: Other Europe: Rest of Europe: Turkey,524,141,383
E09000021,Kingston upon Thames,Europe: United Kingdom,127424,121863,5561
E09000021,Kingston upon Thames,Middle East and Asia: Central Asia,51,51,0
E09000021,Kingston upon Thames,Middle East and Asia: Eastern Asia: China,842,464,378
E09000021,Kingston upon Thames,Middle East and Asia: Eastern Asia: Hong Kong (Special Administrative Region of China),283,62,221
E09000021,Kingston upon Thames,Middle East and Asia: Eastern Asia: Japan,365,468,-103
E09000021,Kingston upon Thames,Middle East and Asia: Eastern Asia: Other Eastern Asia,1459,2023,-564
E09000021,Kingston upon Thames,Middle East and Asia: Middle East: Iran,215,281,-66
E09000021,Kingston upon Thames,Middle East and Asia: Middle East: Iraq,200,104,96
E09000021,Kingston upon Thames,Middle East and Asia: Middle East: Other Middle East,246,299,-53
E09000021,Kingston upon Thames,Middle East and Asia: South-East Asia: Malaysia,199,224,-25
E09000021,Kingston upon Thames,Middle East and Asia: South-East Asia: Other South-East Asia,169,215,-46
E09000021,Kingston upon Thames,Middle East and Asia: South-East Asia: Philippines,700,328,372
E09000021,Kingston upon Thames,Middle East and Asia: South-East Asia: Singapore,63,75,-12
E09000021,Kingston upon Thames,Middle East and Asia: Southern Asia: Afghanistan,59,80,-21
E09000021,Kingston upon Thames,Middle East and Asia: Southern Asia: Bangladesh,89,150,-61
E09000021,Kingston upon Thames,Middle East and Asia: Southern Asia: India,1303,1285,18
E09000021,Kingston upon Thames,Middle East and Asia: Southern Asia: Other Southern Asia,82,95,-13
E09000021,Kingston upon Thames,Middle East and Asia: Southern Asia: Pakistan,457,359,98
E09000021,Kingston upon Thames,Middle East and Asia: Southern Asia: Sri Lanka,529,1019,-490
E09000021,Kingston upon Thames,No passport held,9404,11929,-2525
E09000021,Kingston upon Thames,The Americas and the Caribbean: Central America,44,38,6
E09000021,Kingston upon Thames,The Americas and the Caribbean: North America: Canada,224,258,-34
E09000021,Kingston upon Thames,The Americas and the Caribbean: North America: United States,623,597,26
E09000021,Kingston upon Thames,The Americas and the Caribbean: South America,671,413,258
E09000021,Kingston upon Thames,The Americas and the Caribbean: The Caribbean: Jamaica,32,22,10
E09000021,Kingston upon Thames,The Americas and the Caribbean: The Caribbean: Other Caribbean,75,55,20
E09000022,Lambeth,Africa: Central and Western Africa: Ghana,1311,1882,-571
E09000022,Lambeth,Africa: Central and Western Africa: Nigeria,1525,2892,-1367
E09000022,Lambeth,Africa: Central and Western Africa: Other Central and Western Africa,782,1368,-586
E09000022,Lambeth,Africa: North Africa,452,434,18
E09000022,Lambeth,Africa: South and Eastern Africa: Kenya,71,111,-40
E09000022,Lambeth,Africa: South and Eastern Africa: Other South and Eastern Africa,483,824,-341
E09000022,Lambeth,Africa: South and Eastern Africa: Somalia,35,16,19
E09000022,Lambeth,Africa: South and Eastern Africa: South Africa,555,720,-165
E09000022,Lambeth,Africa: South and Eastern Africa: Zimbabwe,91,209,-118
E09000022,Lambeth,Antarctica and Oceania: Australasia: Australia,1776,2913,-1137
E09000022,Lambeth,Antarctica and Oceania: Australasia: New Zealand,793,1478,-685
E09000022,Lambeth,Antarctica and Oceania: Other Antarctica and Oceania,17,0,17
E09000022,Lambeth,British Overseas Territories,6,23,-17
E09000022,Lambeth,Europe: Ireland,5458,6374,-916
E09000022,Lambeth,Europe: Other Europe: EU Member countries: France,4239,4615,-376
E09000022,Lambeth,Europe: Other Europe: EU Member countries: Germany,1692,2109,-417
E09000022,Lambeth,Europe: Other Europe: EU Member countries: Italy,6988,4792,2196
E09000022,Lambeth,Europe: Other Europe: EU Member countries: Lithuania,625,630,-5
E09000022,Lambeth,Europe: Other Europe: EU Member countries: Other EU countries,7463,6916,547
E09000022,Lambeth,Europe: Other Europe: EU Member countries: Poland,4605,6893,-2288
E09000022,Lambeth,Europe: Other Europe: EU Member countries: Portugal,9212,8713,499
E09000022,Lambeth,Europe: Other Europe: EU Member countries: Romania,1492,658,834
E09000022,Lambeth,Europe: Other Europe: EU Member countries: Spain,8582,2948,5634
E09000022,Lambeth,Europe: Other Europe: Rest of Europe: Other Europe,1459,1079,380
E09000022,Lambeth,Europe: Other Europe: Rest of Europe: Turkey,338,237,101
E09000022,Lambeth,Europe: United Kingdom,228734,208270,20464
E09000022,Lambeth,Middle East and Asia: Central Asia,72,100,-28
E09000022,Lambeth,Middle East and Asia: Eastern Asia: China,1270,650,620
E09000022,Lambeth,Middle East and Asia: Eastern Asia: Hong Kong (Special Administrative Region of China),176,80,96
E09000022,Lambeth,Middle East and Asia: Eastern Asia: Japan,259,356,-97
E09000022,Lambeth,Middle East and Asia: Eastern Asia: Other Eastern Asia,274,289,-15
E09000022,Lambeth,Middle East and Asia: Middle East: Iran,88,70,18
E09000022,Lambeth,Middle East and Asia: Middle East: Iraq,23,25,-2
E09000022,Lambeth,Middle East and Asia: Middle East: Other Middle East,337,212,125
E09000022,Lambeth,Middle East and Asia: South-East Asia: Malaysia,318,384,-66
E09000022,Lambeth,Middle East and Asia: South-East Asia: Other South-East Asia,261,305,-44
E09000022,Lambeth,Middle East and Asia: South-East Asia: Philippines,517,488,29
E09000022,Lambeth,Middle East and Asia: South-East Asia: Singapore,160,194,-34
E09000022,Lambeth,Middle East and Asia: Southern Asia: Afghanistan,67,86,-19
E09000022,Lambeth,Middle East and Asia: Southern Asia: Bangladesh,151,190,-39
E09000022,Lambeth,Middle East and Asia: Southern Asia: India,936,745,191
E09000022,Lambeth,Middle East and Asia: Southern Asia: Other Southern Asia,45,103,-58
E09000022,Lambeth,Middle East and Asia: Southern Asia: Pakistan,425,650,-225
E09000022,Lambeth,Middle East and Asia: Southern Asia: Sri Lanka,88,145,-57
E09000022,Lambeth,No passport held,14690,21434,-6744
E09000022,Lambeth,The Americas and the Caribbean: Central America,328,163,165
E09000022,Lambeth,The Americas and the Caribbean: North America: Canada,709,727,-18
E09000022,Lambeth,The Americas and the Caribbean: North America: United States,1674,1698,-24
E09000022,Lambeth,The Americas and the Caribbean: South America,3878,3664,214
E09000022,Lambeth,The Americas and the Caribbean: The Caribbean: Jamaica,1649,2752,-1103
E09000022,Lambeth,The Americas and the Caribbean: The Caribbean: Other Caribbean,473,472,1
E09000023,Lewisham,Africa: Central and Western Africa: Ghana,886,1396,-510
E09000023,Lewisham,Africa: Central and Western Africa: Nigeria,3397,5428,-2031
E09000023,Lewisham,Africa: Central and Western Africa: Other Central and Western Africa,1069,1463,-394
E09000023,Lewisham,Africa: North Africa,438,412,26
E09000023,Lewisham,Africa: South and Eastern Africa: Kenya,111,214,-103
E09000023,Lewisham,Africa: South and Eastern Africa: Other South and Eastern Africa,427,879,-452
E09000023,Lewisham,Africa: South and Eastern Africa: Somalia,20,8,12
E09000023,Lewisham,Africa: South and Eastern Africa: South Africa,242,584,-342
E09000023,Lewisham,Africa: South and Eastern Africa: Zimbabwe,182,438,-256
E09000023,Lewisham,Antarctica and Oceania: Australasia: Australia,681,837,-156
E09000023,Lewisham,Antarctica and Oceania: Australasia: New Zealand,297,473,-176
E09000023,Lewisham,Antarctica and Oceania: Other Antarctica and Oceania,10,3,7
E09000023,Lewisham,British Overseas Territories,4,11,-7
E09000023,Lewisham,Europe: Ireland,3921,4093,-172
E09000023,Lewisham,Europe: Other Europe: EU Member countries: France,3274,3472,-198
E09000023,Lewisham,Europe: Other Europe: EU Member countries: Germany,1566,1813,-247
E09000023,Lewisham,Europe: Other Europe: EU Member countries: Italy,5354,2426,2928
E09000023,Lewisham,Europe: Other Europe: EU Member countries: Lithuania,1487,1557,-70
E09000023,Lewisham,Europe: Other Europe: EU Member countries: Other EU countries,8248,6051,2197
E09000023,Lewisham,Europe: Other Europe: EU Member countries: Poland,3774,4536,-762
E09000023,Lewisham,Europe: Other Europe: EU Member countries: Portugal,2505,1368,1137
E09000023,Lewisham,Europe: Other Europe: EU Member countries: Romania,3783,735,3048
E09000023,Lewisham,Europe: Other Europe: EU Member countries: Spain,5671,1212,4459
E09000023,Lewisham,Europe: Other Europe: Rest of Europe: Other Europe,1649,1104,545
E09000023,Lewisham,Europe: Other Europe: Rest of Europe: Turkey,437,450,-13
E09000023,Lewisham,Europe: United Kingdom,218043,193451,24592
E09000023,Lewisham,Middle East and Asia: Central Asia,71,69,2
E09000023,Lewisham,Middle East and Asia: Eastern Asia: China,1274,1286,-12
E09000023,Lewisham,Middle East and Asia: Eastern Asia: Hong Kong (Special Administrative Region of China),116,51,65
E09000023,Lewisham,Middle East and Asia: Eastern Asia: Japan,336,487,-151
E09000023,Lewisham,Middle East and Asia: Eastern Asia: Other Eastern Asia,209,302,-93
E09000023,Lewisham,Middle East and Asia: Middle East: Iran,63,92,-29
E09000023,Lewisham,Middle East and Asia: Middle East: Iraq,20,21,-1
E09000023,Lewisham,Middle East and Asia: Middle East: Other Middle East,139,132,7
E09000023,Lewisham,Middle East and Asia: South-East Asia: Malaysia,316,382,-66
E09000023,Lewisham,Middle East and Asia: South-East Asia: Other South-East Asia,426,365,61
E09000023,Lewisham,Middle East and Asia: South-East Asia: Philippines,634,241,393
E09000023,Lewisham,Middle East and Asia: South-East Asia: Singapore,121,130,-9
E09000023,Lewisham,Middle East and Asia: Southern Asia: Afghanistan,128,219,-91
E09000023,Lewisham,Middle East and Asia: Southern Asia: Bangladesh,174,243,-69
E09000023,Lewisham,Middle East and Asia: Southern Asia: India,1329,1504,-175
E09000023,Lewisham,Middle East and Asia: Southern Asia: Other Southern Asia,89,206,-117
E09000023,Lewisham,Middle East and Asia: Southern Asia: Pakistan,292,379,-87
E09000023,Lewisham,Middle East and Asia: Southern Asia: Sri Lanka,736,1027,-291
E09000023,Lewisham,No passport held,20248,28173,-7925
E09000023,Lewisham,The Americas and the Caribbean: Central America,167,91,76
E09000023,Lewisham,The Americas and the Caribbean: North America: Canada,417,343,74
E09000023,Lewisham,The Americas and the Caribbean: North America: United States,1115,954,161
E09000023,Lewisham,The Americas and the Caribbean: South America,2117,1302,815
E09000023,Lewisham,The Americas and the Caribbean: The Caribbean: Jamaica,2013,2911,-898
E09000023,Lewisham,The Americas and the Caribbean: The Caribbean: Other Caribbean,526,561,-35
E09000024,Merton,Africa: Central and Western Africa: Ghana,982,1166,-184
E09000024,Merton,Africa: Central and Western Africa: Nigeria,379,571,-192
E09000024,Merton,Africa: Central and Western Africa: Other Central and Western Africa,162,225,-63
E09000024,Merton,Africa: North Africa,289,217,72
E09000024,Merton,Africa: South and Eastern Africa: Kenya,19,64,-45
E09000024,Merton,Africa: South and Eastern Africa: Other South and Eastern Africa,397,694,-297
E09000024,Merton,Africa: South and Eastern Africa: Somalia,19,5,14
E09000024,Merton,Africa: South and Eastern Africa: South Africa,1002,2596,-1594
E09000024,Merton,Africa: South and Eastern Africa: Zimbabwe,95,294,-199
E09000024,Merton,Antarctica and Oceania: Australasia: Australia,632,1043,-411
E09000024,Merton,Antarctica and Oceania: Australasia: New Zealand,297,535,-238
E09000024,Merton,Antarctica and Oceania: Other Antarctica and Oceania,11,6,5
E09000024,Merton,British Overseas Territories,0,7,-7
E09000024,Merton,Europe: Ireland,3403,3554,-151
E09000024,Merton,Europe: Other Europe: EU Member countries: France,1805,1831,-26
E09000024,Merton,Europe: Other Europe: EU Member countries: Germany,1687,2131,-444
E09000024,Merton,Europe: Other Europe: EU Member countries: Italy,3592,1726,1866
E09000024,Merton,Europe: Other Europe: EU Member countries: Lithuania,837,734,103
E09000024,Merton,Europe: Other Europe: EU Member countries: Other EU countries,7691,4839,2852
E09000024,Merton,Europe: Other Europe: EU Member countries: Poland,6799,6738,61
E09000024,Merton,Europe: Other Europe: EU Member countries: Portugal,2570,1405,1165
E09000024,Merton,Europe: Other Europe: EU Member countries: Romania,3169,563,2606
E09000024,Merton,Europe: Other Europe: EU Member countries: Spain,2335,872,1463
E09000024,Merton,Europe: Other Europe: Rest of Europe: Other Europe,1477,1142,335
E09000024,Merton,Europe: Other Europe: Rest of Europe: Turkey,612,207,405
E09000024,Merton,Europe: United Kingdom,151930,139116,12814
E09000024,Merton,Middle East and Asia: Central Asia,64,58,6
E09000024,Merton,Middle East and Asia: Eastern Asia: China,626,400,226
E09000024,Merton,Middle East and Asia: Eastern Asia: Hong Kong (Special Administrative Region of China),102,16,86
E09000024,Merton,Middle East and Asia: Eastern Asia: Japan,505,685,-180
E09000024,Merton,Middle East and Asia: Eastern Asia: Other Eastern Asia,748,750,-2
E09000024,Merton,Middle East and Asia: Middle East: Iran,94,107,-13
E09000024,Merton,Middle East and Asia: Middle East: Iraq,23,24,-1
E09000024,Merton,Middle East and Asia: Middle East: Other Middle East,117,141,-24
E09000024,Merton,Middle East and Asia: South-East Asia: Malaysia,232,310,-78
E09000024,Merton,Middle East and Asia: South-East Asia: Other South-East Asia,168,203,-35
E09000024,Merton,Middle East and Asia: South-East Asia: Philippines,501,469,32
E09000024,Merton,Middle East and Asia: South-East Asia: Singapore,83,70,13
E09000024,Merton,Middle East and Asia: Southern Asia: Afghanistan,71,125,-54
E09000024,Merton,Middle East and Asia: Southern Asia: Bangladesh,181,317,-136
E09000024,Merton,Middle East and Asia: Southern Asia: India,1665,1805,-140
E09000024,Merton,Middle East and Asia: Southern Asia: Other Southern Asia,263,378,-115
E09000024,Merton,Middle East and Asia: Southern Asia: Pakistan,1200,1506,-306
E09000024,Merton,Middle East and Asia: Southern Asia: Sri Lanka,1030,1856,-826
E09000024,Merton,No passport held,12134,15552,-3418
E09000024,Merton,The Americas and the Caribbean: Central America,71,53,18
E09000024,Merton,The Americas and the Caribbean: North America: Canada,291,346,-55
E09000024,Merton,The Americas and the Caribbean: North America: United States,793,810,-17
E09000024,Merton,The Americas and the Caribbean: South America,1556,838,718
E09000024,Merton,The Americas and the Caribbean: The Caribbean: Jamaica,332,448,-116
E09000024,Merton,The Americas and the Caribbean: The Caribbean: Other Caribbean,151,145,6
E09000025,Newham,Africa: Central and Western Africa: Ghana,1486,2490,-1004
E09000025,Newham,Africa: Central and Western Africa: Nigeria,2379,4569,-2190
E09000025,Newham,Africa: Central and Western Africa: Other Central and Western Africa,805,1428,-623
E09000025,Newham,Africa: North Africa,640,511,129
E09000025,Newham,Africa: South and Eastern Africa: Kenya,180,307,-127
E09000025,Newham,Africa: South and Eastern Africa: Other South and Eastern Africa,838,1791,-953
E09000025,Newham,Africa: South and Eastern Africa: Somalia,51,37,14
E09000025,Newham,Africa: South and Eastern Africa: South Africa,279,707,-428
E09000025,Newham,Africa: South and Eastern Africa: Zimbabwe,169,402,-233
E09000025,Newham,Antarctica and Oceania: Australasia: Australia,339,340,-1
E09000025,Newham,Antarctica and Oceania: Australasia: New Zealand,157,185,-28
E09000025,Newham,Antarctica and Oceania: Other Antarctica and Oceania,2,29,-27
E09000025,Newham,British Overseas Territories,4,23,-19
E09000025,Newham,Europe: Ireland,1941,1852,89
E09000025,Newham,Europe: Other Europe: EU Member countries: France,2493,2364,129
E09000025,Newham,Europe: Other Europe: EU Member countries: Germany,1127,1223,-96
E09000025,Newham,Europe: Other Europe: EU Member countries: Italy,12247,1739,10508
E09000025,Newham,Europe: Other Europe: EU Member countries: Lithuania,7045,9088,-2043
E09000025,Newham,Europe: Other Europe: EU Member countries: Other EU countries,13005,8797,4208
E09000025,Newham,Europe: Other Europe: EU Member countries: Poland,4235,6229,-1994
E09000025,Newham,Europe: Other Europe: EU Member countries: Portugal,6084,3225,2859
E09000025,Newham,Europe: Other Europe: EU Member countries: Romania,20081,4798,15283
E09000025,Newham,Europe: Other Europe: EU Member countries: Spain,4470,1185,3285
E09000025,Newham,Europe: Other Europe: Rest of Europe: Other Europe,2298,1128,1170
E09000025,Newham,Europe: Other Europe: Rest of Europe: Turkey,331,240,91
E09000025,Newham,Europe: United Kingdom,215348,184579,30769
E09000025,Newham,Middle East and Asia: Central Asia,174,154,20
E09000025,Newham,Middle East and Asia: Eastern Asia: China,1820,1025,795
E09000025,Newham,Middle East and Asia: Eastern Asia: Hong Kong (Special Administrative Region of China),244,38,206
E09000025,Newham,Middle East and Asia: Eastern Asia: Japan,149,117,32
E09000025,Newham,Middle East and Asia: Eastern Asia: Other Eastern Asia,297,102,195
E09000025,Newham,Middle East and Asia: Middle East: Iran,66,163,-97
E09000025,Newham,Middle East and Asia: Middle East: Iraq,10,20,-10
E09000025,Newham,Middle East and Asia: Middle East: Other Middle East,291,242,49
E09000025,Newham,Middle East and Asia: South-East Asia: Malaysia,621,551,70
E09000025,Newham,Middle East and Asia: South-East Asia: Other South-East Asia,403,387,16
E09000025,Newham,Middle East and Asia: South-East Asia: Philippines,1114,1597,-483
E09000025,Newham,Middle East and Asia: South-East Asia: Singapore,219,70,149
E09000025,Newham,Middle East and Asia: Southern Asia: Afghanistan,179,400,-221
E09000025,Newham,Middle East and Asia: Southern Asia: Bangladesh,8019,9544,-1525
E09000025,Newham,Middle East and Asia: Southern Asia: India,11559,17643,-6084
E09000025,Newham,Middle East and Asia: Southern Asia: Other Southern Asia,304,962,-658
E09000025,Newham,Middle East and Asia: Southern Asia: Pakistan,4034,8127,-4093
E09000025,Newham,Middle East and Asia: Southern Asia: Sri Lanka,925,1966,-1041
E09000025,Newham,No passport held,18808,22267,-3459
E09000025,Newham,The Americas and the Caribbean: Central America,91,38,53
E09000025,Newham,The Americas and the Caribbean: North America: Canada,269,179,90
E09000025,Newham,The Americas and the Caribbean: North America: United States,615,419,196
E09000025,Newham,The Americas and the Caribbean: South America,1830,1401,429
E09000025,Newham,The Americas and the Caribbean: The Caribbean: Jamaica,547,783,-236
E09000025,Newham,The Americas and the Caribbean: The Caribbean: Other Caribbean,416,523,-107
E09000026,Redbridge,Africa: Central and Western Africa: Ghana,363,471,-108
E09000026,Redbridge,Africa: Central and Western Africa: Nigeria,898,1102,-204
E09000026,Redbridge,Africa: Central and Western Africa: Other Central and Western Africa,262,288,-26
E09000026,Redbridge,Africa: North Africa,378,252,126
E09000026,Redbridge,Africa: South and Eastern Africa: Kenya,148,202,-54
E09000026,Redbridge,Africa: South and Eastern Africa: Other South and Eastern Africa,608,1162,-554
E09000026,Redbridge,Africa: South and Eastern Africa: Somalia,10,2,8
E09000026,Redbridge,Africa: South and Eastern Africa: South Africa,134,559,-425
E09000026,Redbridge,Africa: South and Eastern Africa: Zimbabwe,85,303,-218
E09000026,Redbridge,Antarctica and Oceania: Australasia: Australia,219,301,-82
E09000026,Redbridge,Antarctica and Oceania: Australasia: New Zealand,78,127,-49
E09000026,Redbridge,Antarctica and Oceania: Other Antarctica and Oceania,1,6,-5
E09000026,Redbridge,British Overseas Territories,1,7,-6
E09000026,Redbridge,Europe: Ireland,2466,3167,-701
E09000026,Redbridge,Europe: Other Europe: EU Member countries: France,1646,1603,43
E09000026,Redbridge,Europe: Other Europe: EU Member countries: Germany,1274,1365,-91
E09000026,Redbridge,Europe: Other Europe: EU Member countries: Italy,5973,900,5073
E09000026,Redbridge,Europe: Other Europe: EU Member countries: Lithuania,3528,3223,305
E09000026,Redbridge,Europe: Other Europe: EU Member countries: Other EU countries,6787,3914,2873
E09000026,Redbridge,Europe: Other Europe: EU Member countries: Poland,2505,2493,12
E09000026,Redbridge,Europe: Other Europe: EU Member countries: Portugal,2159,924,1235
E09000026,Redbridge,Europe: Other Europe: EU Member countries: Romania,14460,1848,12612
E09000026,Redbridge,Europe: Other Europe: EU Member countries: Spain,1582,357,1225
E09000026,Redbridge,Europe: Other Europe: Rest of Europe: Other Europe,1938,845,1093
E09000026,Redbridge,Europe: Other Europe: Rest of Europe: Turkey,290,222,68
E09000026,Redbridge,Europe: United Kingdom,224798,211701,13097
E09000026,Redbridge,Middle East and Asia: Central Asia,32,27,5
E09000026,Redbridge,Middle East and Asia: Eastern Asia: China,327,251,76
E09000026,Redbridge,Middle East and Asia: Eastern Asia: Hong Kong (Special Administrative Region of China),33,19,14
E09000026,Redbridge,Middle East and Asia: Eastern Asia: Japan,117,119,-2
E09000026,Redbridge,Middle East and Asia: Eastern Asia: Other Eastern Asia,41,29,12
E09000026,Redbridge,Middle East and Asia: Middle East: Iran,65,73,-8
E09000026,Redbridge,Middle East and Asia: Middle East: Iraq,19,36,-17
E09000026,Redbridge,Middle East and Asia: Middle East: Other Middle East,136,129,7
E09000026,Redbridge,Middle East and Asia: South-East Asia: Malaysia,227,389,-162
E09000026,Redbridge,Middle East and Asia: South-East Asia: Other South-East Asia,154,173,-19
E09000026,Redbridge,Middle East and Asia: South-East Asia: Philippines,284,268,16
E09000026,Redbridge,Middle East and Asia: South-East Asia: Singapore,61,72,-11
E09000026,Redbridge,Middle East and Asia: Southern Asia: Afghanistan,130,229,-99
E09000026,Redbridge,Middle East and Asia: Southern Asia: Bangladesh,3038,1510,1528
E09000026,Redbridge,Middle East and Asia: Southern Asia: India,10335,9965,370
E09000026,Redbridge,Middle East and Asia: Southern Asia: Other Southern Asia,65,163,-98
E09000026,Redbridge,Middle East and Asia: Southern Asia: Pakistan,5120,6375,-1255
E09000026,Redbridge,Middle East and Asia: Southern Asia: Sri Lanka,1221,2048,-827
E09000026,Redbridge,No passport held,14952,18082,-3130
E09000026,Redbridge,The Americas and the Caribbean: Central America,44,17,27
E09000026,Redbridge,The Americas and the Caribbean: North America: Canada,156,245,-89
E09000026,Redbridge,The Americas and the Caribbean: North America: United States,324,465,-141
E09000026,Redbridge,The Americas and the Caribbean: South America,399,346,53
E09000026,Redbridge,The Americas and the Caribbean: The Caribbean: Jamaica,226,349,-123
E09000026,Redbridge,The Americas and the Caribbean: The Caribbean: Other Caribbean,163,247,-84
E09000027,Richmond upon Thames,Africa: Central and Western Africa: Ghana,60,66,-6
E09000027,Richmond upon Thames,Africa: Central and Western Africa: Nigeria,90,80,10
E09000027,Richmond upon Thames,Africa: Central and Western Africa: Other Central and Western Africa,63,62,1
E09000027,Richmond upon Thames,Africa: North Africa,212,169,43
E09000027,Richmond upon Thames,Africa: South and Eastern Africa: Kenya,19,52,-33
E09000027,Richmond upon Thames,Africa: South and Eastern Africa: Other South and Eastern Africa,90,112,-22
E09000027,Richmond upon Thames,Africa: South and Eastern Africa: Somalia,1,3,-2
E09000027,Richmond upon Thames,Africa: South and Eastern Africa: South Africa,599,823,-224
E09000027,Richmond upon Thames,Africa: South and Eastern Africa: Zimbabwe,90,116,-26
E09000027,Richmond upon Thames,Antarctica and Oceania: Australasia: Australia,1004,1418,-414
E09000027,Richmond upon Thames,Antarctica and Oceania: Australasia: New Zealand,352,632,-280
E09000027,Richmond upon Thames,Antarctica and Oceania: Other Antarctica and Oceania,2,4,-2
E09000027,Richmond upon Thames,British Overseas Territories,0,17,-17
E09000027,Richmond upon Thames,Europe: Ireland,3721,4003,-282
E09000027,Richmond upon Thames,Europe: Other Europe: EU Member countries: France,1312,1434,-122
E09000027,Richmond upon Thames,Europe: Other Europe: EU Member countries: Germany,1660,2105,-445
E09000027,Richmond upon Thames,Europe: Other Europe: EU Member countries: Italy,2354,1438,916
E09000027,Richmond upon Thames,Europe: Other Europe: EU Member countries: Lithuania,474,236,238
E09000027,Richmond upon Thames,Europe: Other Europe: EU Member countries: Other EU countries,5455,4211,1244
E09000027,Richmond upon Thames,Europe: Other Europe: EU Member countries: Poland,2162,1918,244
E09000027,Richmond upon Thames,Europe: Other Europe: EU Member countries: Portugal,965,445,520
E09000027,Richmond upon Thames,Europe: Other Europe: EU Member countries: Romania,858,166,692
E09000027,Richmond upon Thames,Europe: Other Europe: EU Member countries: Spain,1448,792,656
E09000027,Richmond upon Thames,Europe: Other Europe: Rest of Europe: Other Europe,1283,889,394
E09000027,Richmond upon Thames,Europe: Other Europe: Rest of Europe: Turkey,1371,151,1220
E09000027,Richmond upon Thames,Europe: United Kingdom,154737,148370,6367
E09000027,Richmond upon Thames,Middle East and Asia: Central Asia,50,46,4
E09000027,Richmond upon Thames,Middle East and Asia: Eastern Asia: China,584,238,346
E09000027,Richmond upon Thames,Middle East and Asia: Eastern Asia: Hong Kong (Special Administrative Region of China),177,13,164
E09000027,Richmond upon Thames,Middle East and Asia: Eastern Asia: Japan,439,518,-79
E09000027,Richmond upon Thames,Middle East and Asia: Eastern Asia: Other Eastern Asia,137,115,22
E09000027,Richmond upon Thames,Middle East and Asia: Middle East: Iran,139,215,-76
E09000027,Richmond upon Thames,Middle East and Asia: Middle East: Iraq,18,31,-13
E09000027,Richmond upon Thames,Middle East and Asia: Middle East: Other Middle East,203,165,38
E09000027,Richmond upon Thames,Middle East and Asia: South-East Asia: Malaysia,162,189,-27
E09000027,Richmond upon Thames,Middle East and Asia: South-East Asia: Other South-East Asia,173,157,16
E09000027,Richmond upon Thames,Middle East and Asia: South-East Asia: Philippines,168,201,-33
E09000027,Richmond upon Thames,Middle East and Asia: South-East Asia: Singapore,78,86,-8
E09000027,Richmond upon Thames,Middle East and Asia: Southern Asia: Afghanistan,94,99,-5
E09000027,Richmond upon Thames,Middle East and Asia: Southern Asia: Bangladesh,58,128,-70
E09000027,Richmond upon Thames,Middle East and Asia: Southern Asia: India,968,744,224
E09000027,Richmond upon Thames,Middle East and Asia: Southern Asia: Other Southern Asia,50,49,1
E09000027,Richmond upon Thames,Middle East and Asia: Southern Asia: Pakistan,179,186,-7
E09000027,Richmond upon Thames,Middle East and Asia: Southern Asia: Sri Lanka,102,148,-46
E09000027,Richmond upon Thames,No passport held,8098,11031,-2933
E09000027,Richmond upon Thames,The Americas and the Caribbean: Central America,104,109,-5
E09000027,Richmond upon Thames,The Americas and the Caribbean: North America: Canada,389,422,-33
E09000027,Richmond upon Thames,The Americas and the Caribbean: North America: United States,1593,1849,-256
E09000027,Richmond upon Thames,The Americas and the Caribbean: South America,837,450,387
E09000027,Richmond upon Thames,The Americas and the Caribbean: The Caribbean: Jamaica,25,32,-7
E09000027,Richmond upon Thames,The Americas and the Caribbean: The Caribbean: Other Caribbean,73,57,16
E09000028,Southwark,Africa: Central and Western Africa: Ghana,1290,2171,-881
E09000028,Southwark,Africa: Central and Western Africa: Nigeria,3742,7223,-3481
E09000028,Southwark,Africa: Central and Western Africa: Other Central and Western Africa,1542,2825,-1283
E09000028,Southwark,Africa: North Africa,594,548,46
E09000028,Southwark,Africa: South and Eastern Africa: Kenya,97,204,-107
E09000028,Southwark,Africa: South and Eastern Africa: Other South and Eastern Africa,523,903,-380
E09000028,Southwark,Africa: South and Eastern Africa: Somalia,14,13,1
E09000028,Southwark,Africa: South and Eastern Africa: South Africa,332,903,-571
E09000028,Southwark,Africa: South and Eastern Africa: Zimbabwe,102,251,-149
E09000028,Southwark,Antarctica and Oceania: Australasia: Australia,1331,1927,-596
E09000028,Southwark,Antarctica and Oceania: Australasia: New Zealand,520,779,-259
E09000028,Southwark,Antarctica and Oceania: Other Antarctica and Oceania,14,3,11
E09000028,Southwark,British Overseas Territories,1,18,-17
E09000028,Southwark,Europe: Ireland,4733,5244,-511
E09000028,Southwark,Europe: Other Europe: EU Member countries: France,4303,4152,151
E09000028,Southwark,Europe: Other Europe: EU Member countries: Germany,1995,2211,-216
E09000028,Southwark,Europe: Other Europe: EU Member countries: Italy,6854,3924,2930
E09000028,Southwark,Europe: Other Europe: EU Member countries: Lithuania,927,897,30
E09000028,Southwark,Europe: Other Europe: EU Member countries: Other EU countries,8672,7028,1644
E09000028,Southwark,Europe: Other Europe: EU Member countries: Poland,2634,3564,-930
E09000028,Southwark,Europe: Other Europe: EU Member countries: Portugal,2797,2238,559
E09000028,Southwark,Europe: Other Europe: EU Member countries: Romania,1615,584,1031
E09000028,Southwark,Europe: Other Europe: EU Member countries: Spain,9222,2552,6670
E09000028,Southwark,Europe: Other Europe: Rest of Europe: Other Europe,1814,1425,389
E09000028,Southwark,Europe: Other Europe: Rest of Europe: Turkey,464,419,45
E09000028,Southwark,Europe: United Kingdom,218332,195938,22394
E09000028,Southwark,Middle East and Asia: Central Asia,105,146,-41
E09000028,Southwark,Middle East and Asia: Eastern Asia: China,2191,2235,-44
E09000028,Southwark,Middle East and Asia: Eastern Asia: Hong Kong (Special Administrative Region of China),313,152,161
E09000028,Southwark,Middle East and Asia: Eastern Asia: Japan,391,552,-161
E09000028,Southwark,Middle East and Asia: Eastern Asia: Other Eastern Asia,456,546,-90
E09000028,Southwark,Middle East and Asia: Middle East: Iran,108,133,-25
E09000028,Southwark,Middle East and Asia: Middle East: Iraq,45,64,-19
E09000028,Southwark,Middle East and Asia: Middle East: Other Middle East,308,222,86
E09000028,Southwark,Middle East and Asia: South-East Asia: Malaysia,603,691,-88
E09000028,Southwark,Middle East and Asia: South-East Asia: Other South-East Asia,464,589,-125
E09000028,Southwark,Middle East and Asia: South-East Asia: Philippines,916,526,390
E09000028,Southwark,Middle East and Asia: South-East Asia: Singapore,309,225,84
E09000028,Southwark,Middle East and Asia: Southern Asia: Afghanistan,149,138,11
E09000028,Southwark,Middle East and Asia: Southern Asia: Bangladesh,355,360,-5
E09000028,Southwark,Middle East and Asia: Southern Asia: India,1699,1660,39
E09000028,Southwark,Middle East and Asia: Southern Asia: Other Southern Asia,37,72,-35
E09000028,Southwark,Middle East and Asia: Southern Asia: Pakistan,318,434,-116
E09000028,Southwark,Middle East and Asia: Southern Asia: Sri Lanka,59,153,-94
E09000028,Southwark,No passport held,15964,23197,-7233
E09000028,Southwark,The Americas and the Caribbean: Central America,276,184,92
E09000028,Southwark,The Americas and the Caribbean: North America: Canada,864,745,119
E09000028,Southwark,The Americas and the Caribbean: North America: United States,2051,1759,292
E09000028,Southwark,The Americas and the Caribbean: South America,3730,3542,188
E09000028,Southwark,The Americas and the Caribbean: The Caribbean: Jamaica,1013,1643,-630
E09000028,Southwark,The Americas and the Caribbean: The Caribbean: Other Caribbean,448,371,77
E09000029,Sutton,Africa: Central and Western Africa: Ghana,374,323,51
E09000029,Sutton,Africa: Central and Western Africa: Nigeria,332,380,-48
E09000029,Sutton,Africa: Central and Western Africa: Other Central and Western Africa,94,93,1
E09000029,Sutton,Africa: North Africa,186,108,78
E09000029,Sutton,Africa: South and Eastern Africa: Kenya,22,50,-28
E09000029,Sutton,Africa: South and Eastern Africa: Other South and Eastern Africa,338,581,-243
E09000029,Sutton,Africa: South and Eastern Africa: Somalia,8,0,8
E09000029,Sutton,Africa: South and Eastern Africa: South Africa,372,662,-290
E09000029,Sutton,Africa: South and Eastern Africa: Zimbabwe,153,328,-175
E09000029,Sutton,Antarctica and Oceania: Australasia: Australia,218,208,10
E09000029,Sutton,Antarctica and Oceania: Australasia: New Zealand,100,144,-44
E09000029,Sutton,Antarctica and Oceania: Other Antarctica and Oceania,4,6,-2
E09000029,Sutton,British Overseas Territories,0,4,-4
E09000029,Sutton,Europe: Ireland,2265,2397,-132
E09000029,Sutton,Europe: Other Europe: EU Member countries: France,879,724,155
E09000029,Sutton,Europe: Other Europe: EU Member countries: Germany,1128,841,287
E09000029,Sutton,Europe: Other Europe: EU Member countries: Italy,1700,874,826
E09000029,Sutton,Europe: Other Europe: EU Member countries: Lithuania,683,360,323
E09000029,Sutton,Europe: Other Europe: EU Member countries: Other EU countries,4612,2107,2505
E09000029,Sutton,Europe: Other Europe: EU Member countries: Poland,3293,2092,1201
E09000029,Sutton,Europe: Other Europe: EU Member countries: Portugal,1431,697,734
E09000029,Sutton,Europe: Other Europe: EU Member countries: Romania,1875,308,1567
E09000029,Sutton,Europe: Other Europe: EU Member countries: Spain,908,448,460
E09000029,Sutton,Europe: Other Europe: Rest of Europe: Other Europe,896,468,428
E09000029,Sutton,Europe: Other Europe: Rest of Europe: Turkey,472,149,323
E09000029,Sutton,Europe: United Kingdom,163866,150697,13169
E09000029,Sutton,Middle East and Asia: Central Asia,29,15,14
E09000029,Sutton,Middle East and Asia: Eastern Asia: China,700,283,417
E09000029,Sutton,Middle East and Asia: Eastern Asia: Hong Kong (Special Administrative Region of China),190,17,173
E09000029,Sutton,Middle East and Asia: Eastern Asia: Japan,218,184,34
E09000029,Sutton,Middle East and Asia: Eastern Asia: Other Eastern Asia,323,436,-113
E09000029,Sutton,Middle East and Asia: Middle East: Iran,94,130,-36
E09000029,Sutton,Middle East and Asia: Middle East: Iraq,44,71,-27
E09000029,Sutton,Middle East and Asia: Middle East: Other Middle East,71,34,37
E09000029,Sutton,Middle East and Asia: South-East Asia: Malaysia,225,278,-53
E09000029,Sutton,Middle East and Asia: South-East Asia: Other South-East Asia,190,127,63
E09000029,Sutton,Middle East and Asia: South-East Asia: Philippines,311,396,-85
E09000029,Sutton,Middle East and Asia: South-East Asia: Singapore,44,41,3
E09000029,Sutton,Middle East and Asia: Southern Asia: Afghanistan,50,56,-6
E09000029,Sutton,Middle East and Asia: Southern Asia: Bangladesh,158,158,0
E09000029,Sutton,Middle East and Asia: Southern Asia: India,2329,1296,1033
E09000029,Sutton,Middle East and Asia: Southern Asia: Other Southern Asia,216,201,15
E09000029,Sutton,Middle East and Asia: Southern Asia: Pakistan,783,433,350
E09000029,Sutton,Middle East and Asia: Southern Asia: Sri Lanka,894,925,-31
E09000029,Sutton,No passport held,15304,19092,-3788
E09000029,Sutton,The Americas and the Caribbean: Central America,27,19,8
E09000029,Sutton,The Americas and the Caribbean: North America: Canada,135,134,1
E09000029,Sutton,The Americas and the Caribbean: North America: United States,278,240,38
E09000029,Sutton,The Americas and the Caribbean: South America,639,347,292
E09000029,Sutton,The Americas and the Caribbean: The Caribbean: Jamaica,118,100,18
E09000029,Sutton,The Americas and the Caribbean: The Caribbean: Other Caribbean,54,84,-30
E09000030,Tower Hamlets,Africa: Central and Western Africa: Ghana,256,320,-64
E09000030,Tower Hamlets,Africa: Central and Western Africa: Nigeria,654,654,0
E09000030,Tower Hamlets,Africa: Central and Western Africa: Other Central and Western Africa,278,306,-28
E09000030,Tower Hamlets,Africa: North Africa,738,529,209
E09000030,Tower Hamlets,Africa: South and Eastern Africa: Kenya,97,89,8
E09000030,Tower Hamlets,Africa: South and Eastern Africa: Other South and Eastern Africa,265,352,-87
E09000030,Tower Hamlets,Africa: South and Eastern Africa: Somalia,52,41,11
E09000030,Tower Hamlets,Africa: South and Eastern Africa: South Africa,408,595,-187
E09000030,Tower Hamlets,Africa: South and Eastern Africa: Zimbabwe,105,131,-26
E09000030,Tower Hamlets,Antarctica and Oceania: Australasia: Australia,1565,2237,-672
E09000030,Tower Hamlets,Antarctica and Oceania: Australasia: New Zealand,600,896,-296
E09000030,Tower Hamlets,Antarctica and Oceania: Other Antarctica and Oceania,7,4,3
E09000030,Tower Hamlets,British Overseas Territories,4,25,-21
E09000030,Tower Hamlets,Europe: Ireland,3069,3084,-15
E09000030,Tower Hamlets,Europe: Other Europe: EU Member countries: France,4911,3379,1532
E09000030,Tower Hamlets,Europe: Other Europe: EU Member countries: Germany,2042,2163,-121
E09000030,Tower Hamlets,Europe: Other Europe: EU Member countries: Italy,13788,3465,10323
E09000030,Tower Hamlets,Europe: Other Europe: EU Member countries: Lithuania,1791,1199,592
E09000030,Tower Hamlets,Europe: Other Europe: EU Member countries: Other EU countries,10478,7130,3348
E09000030,Tower Hamlets,Europe: Other Europe: EU Member countries: Poland,2664,2607,57
E09000030,Tower Hamlets,Europe: Other Europe: EU Member countries: Portugal,2816,1139,1677
E09000030,Tower Hamlets,Europe: Other Europe: EU Member countries: Romania,2626,520,2106
E09000030,Tower Hamlets,Europe: Other Europe: EU Member countries: Spain,4899,2212,2687
E09000030,Tower Hamlets,Europe: Other Europe: Rest of Europe: Other Europe,2813,1860,953
E09000030,Tower Hamlets,Europe: Other Europe: Rest of Europe: Turkey,765,455,310
E09000030,Tower Hamlets,Europe: United Kingdom,211534,176531,35003
E09000030,Tower Hamlets,Middle East and Asia: Central Asia,284,349,-65
E09000030,Tower Hamlets,Middle East and Asia: Eastern Asia: China,3531,2877,654
E09000030,Tower Hamlets,Middle East and Asia: Eastern Asia: Hong Kong (Special Administrative Region of China),412,148,264
E09000030,Tower Hamlets,Middle East and Asia: Eastern Asia: Japan,471,597,-126
E09000030,Tower Hamlets,Middle East and Asia: Eastern Asia: Other Eastern Asia,548,510,38
E09000030,Tower Hamlets,Middle East and Asia: Middle East: Iran,140,145,-5
E09000030,Tower Hamlets,Middle East and Asia: Middle East: Iraq,25,31,-6
E09000030,Tower Hamlets,Middle East and Asia: Middle East: Other Middle East,438,391,47
E09000030,Tower Hamlets,Middle East and Asia: South-East Asia: Malaysia,844,779,65
E09000030,Tower Hamlets,Middle East and Asia: South-East Asia: Other South-East Asia,592,531,61
E09000030,Tower Hamlets,Middle East and Asia: South-East Asia: Philippines,533,235,298
E09000030,Tower Hamlets,Middle East and Asia: South-East Asia: Singapore,448,301,147
E09000030,Tower Hamlets,Middle East and Asia: Southern Asia: Afghanistan,56,34,22
E09000030,Tower Hamlets,Middle East and Asia: Southern Asia: Bangladesh,8744,10192,-1448
E09000030,Tower Hamlets,Middle East and Asia: Southern Asia: India,4579,3039,1540
E09000030,Tower Hamlets,Middle East and Asia: Southern Asia: Other Southern Asia,49,91,-42
E09000030,Tower Hamlets,Middle East and Asia: Southern Asia: Pakistan,613,566,47
E09000030,Tower Hamlets,Middle East and Asia: Southern Asia: Sri Lanka,96,110,-14
E09000030,Tower Hamlets,No passport held,13535,16790,-3255
E09000030,Tower Hamlets,The Americas and the Caribbean: Central America,237,139,98
E09000030,Tower Hamlets,The Americas and the Caribbean: North America: Canada,894,772,122
E09000030,Tower Hamlets,The Americas and the Caribbean: North America: United States,1939,1794,145
E09000030,Tower Hamlets,The Americas and the Caribbean: South America,1752,1276,476
E09000030,Tower Hamlets,The Americas and the Caribbean: The Caribbean: Jamaica,122,211,-89
E09000030,Tower Hamlets,The Americas and the Caribbean: The Caribbean: Other Caribbean,200,265,-65
E09000031,Waltham Forest,Africa: Central and Western Africa: Ghana,842,1498,-656
E09000031,Waltham Forest,Africa: Central and Western Africa: Nigeria,690,1475,-785
E09000031,Waltham Forest,Africa: Central and Western Africa: Other Central and Western Africa,339,480,-141
E09000031,Waltham Forest,Africa: North Africa,639,744,-105
E09000031,Waltham Forest,Africa: South and Eastern Africa: Kenya,51,91,-40
E09000031,Waltham Forest,Africa: South and Eastern Africa: Other South and Eastern Africa,620,1382,-762
E09000031,Waltham Forest,Africa: South and Eastern Africa: Somalia,38,27,11
E09000031,Waltham Forest,Africa: South and Eastern Africa: South Africa,224,769,-545
E09000031,Waltham Forest,Africa: South and Eastern Africa: Zimbabwe,82,266,-184
E09000031,Waltham Forest,Antarctica and Oceania: Australasia: Australia,519,401,118
E09000031,Waltham Forest,Antarctica and Oceania: Australasia: New Zealand,259,206,53
E09000031,Waltham Forest,Antarctica and Oceania: Other Antarctica and Oceania,4,12,-8
E09000031,Waltham Forest,British Overseas Territories,1,19,-18
E09000031,Waltham Forest,Europe: Ireland,3168,3150,18
E09000031,Waltham Forest,Europe: Other Europe: EU Member countries: France,1854,2342,-488
E09000031,Waltham Forest,Europe: Other Europe: EU Member countries: Germany,868,964,-96
E09000031,Waltham Forest,Europe: Other Europe: EU Member countries: Italy,3706,1521,2185
E09000031,Waltham Forest,Europe: Other Europe: EU Member countries: Lithuania,2981,3908,-927
E09000031,Waltham Forest,Europe: Other Europe: EU Member countries: Other EU countries,11609,8212,3397
E09000031,Waltham Forest,Europe: Other Europe: EU Member countries: Poland,5620,8516,-2896
E09000031,Waltham Forest,Europe: Other Europe: EU Member countries: Portugal,2125,1529,596
E09000031,Waltham Forest,Europe: Other Europe: EU Member countries: Romania,12434,4295,8139
E09000031,Waltham Forest,Europe: Other Europe: EU Member countries: Spain,2531,919,1612
E09000031,Waltham Forest,Europe: Other Europe: Rest of Europe: Other Europe,2237,965,1272
E09000031,Waltham Forest,Europe: Other Europe: Rest of Europe: Turkey,756,723,33
E09000031,Waltham Forest,Europe: United Kingdom,198787,176847,21940
E09000031,Waltham Forest,Middle East and Asia: Central Asia,79,115,-36
E09000031,Waltham Forest,Middle East and Asia: Eastern Asia: China,492,694,-202
E09000031,Waltham Forest,Middle East and Asia: Eastern Asia: Hong Kong (Special Administrative Region of China),29,13,16
E09000031,Waltham Forest,Middle East and Asia: Eastern Asia: Japan,174,157,17
E09000031,Waltham Forest,Middle East and Asia: Eastern Asia: Other Eastern Asia,84,56,28
E09000031,Waltham Forest,Middle East and Asia: Middle East: Iran,34,55,-21
E09000031,Waltham Forest,Middle East and Asia: Middle East: Iraq,6,13,-7
E09000031,Waltham Forest,Middle East and Asia: Middle East: Other Middle East,95,84,11
E09000031,Waltham Forest,Middle East and Asia: South-East Asia: Malaysia,189,308,-119
E09000031,Waltham Forest,Middle East and Asia: South-East Asia: Other South-East Asia,181,313,-132
E09000031,Waltham Forest,Middle East and Asia: South-East Asia: Philippines,451,462,-11
E09000031,Waltham Forest,Middle East and Asia: South-East Asia: Singapore,28,17,11
E09000031,Waltham Forest,Middle East and Asia: Southern Asia: Afghanistan,144,328,-184
E09000031,Waltham Forest,Middle East and Asia: Southern Asia: Bangladesh,654,1121,-467
E09000031,Waltham Forest,Middle East and Asia: Southern Asia: India,1003,1815,-812
E09000031,Waltham Forest,Middle East and Asia: Southern Asia: Other Southern Asia,26,129,-103
E09000031,Waltham Forest,Middle East and Asia: Southern Asia: Pakistan,2541,4857,-2316
E09000031,Waltham Forest,Middle East and Asia: Southern Asia: Sri Lanka,343,777,-434
E09000031,Waltham Forest,No passport held,16019,22479,-6460
E09000031,Waltham Forest,The Americas and the Caribbean: Central America,60,105,-45
E09000031,Waltham Forest,The Americas and the Caribbean: North America: Canada,269,187,82
E09000031,Waltham Forest,The Americas and the Caribbean: North America: United States,618,461,157
E09000031,Waltham Forest,The Americas and the Caribbean: South America,955,834,121
E09000031,Waltham Forest,The Americas and the Caribbean: The Caribbean: Jamaica,647,1082,-435
E09000031,Waltham Forest,The Americas and the Caribbean: The Caribbean: Other Caribbean,327,526,-199
E09000032,Wandsworth,Africa: Central and Western Africa: Ghana,481,666,-185
E09000032,Wandsworth,Africa: Central and Western Africa: Nigeria,440,621,-181
E09000032,Wandsworth,Africa: Central and Western Africa: Other Central and Western Africa,205,243,-38
E09000032,Wandsworth,Africa: North Africa,595,404,191
E09000032,Wandsworth,Africa: South and Eastern Africa: Kenya,56,90,-34
E09000032,Wandsworth,Africa: South and Eastern Africa: Other South and Eastern Africa,429,638,-209
E09000032,Wandsworth,Africa: South and Eastern Africa: Somalia,46,19,27
E09000032,Wandsworth,Africa: South and Eastern Africa: South Africa,1452,2792,-1340
E09000032,Wandsworth,Africa: South and Eastern Africa: Zimbabwe,122,145,-23
E09000032,Wandsworth,Antarctica and Oceania: Australasia: Australia,2520,4303,-1783
E09000032,Wandsworth,Antarctica and Oceania: Australasia: New Zealand,1120,2571,-1451
E09000032,Wandsworth,Antarctica and Oceania: Other Antarctica and Oceania,1,3,-2
E09000032,Wandsworth,British Overseas Territories,3,8,-5
E09000032,Wandsworth,Europe: Ireland,6746,6655,91
E09000032,Wandsworth,Europe: Other Europe: EU Member countries: France,5170,4519,651
E09000032,Wandsworth,Europe: Other Europe: EU Member countries: Germany,2990,3389,-399
E09000032,Wandsworth,Europe: Other Europe: EU Member countries: Italy,8189,4262,3927
E09000032,Wandsworth,Europe: Other Europe: EU Member countries: Lithuania,885,668,217
E09000032,Wandsworth,Europe: Other Europe: EU Member countries: Other EU countries,10832,8456,2376
E09000032,Wandsworth,Europe: Other Europe: EU Member countries: Poland,5187,6525,-1338
E09000032,Wandsworth,Europe: Other Europe: EU Member countries: Portugal,3172,2012,1160
E09000032,Wandsworth,Europe: Other Europe: EU Member countries: Romania,1647,397,1250
E09000032,Wandsworth,Europe: Other Europe: EU Member countries: Spain,5262,2039,3223
E09000032,Wandsworth,Europe: Other Europe: Rest of Europe: Other Europe,2383,1510,873
E09000032,Wandsworth,Europe: Other Europe: Rest of Europe: Turkey,974,460,514
E09000032,Wandsworth,Europe: United Kingdom,237835,220193,17642
E09000032,Wandsworth,Middle East and Asia: Central Asia,115,51,64
E09000032,Wandsworth,Middle East and Asia: Eastern Asia: China,1002,510,492
E09000032,Wandsworth,Middle East and Asia: Eastern Asia: Hong Kong (Special Administrative Region of China),160,30,130
E09000032,Wandsworth,Middle East and Asia: Eastern Asia: Japan,462,600,-138
E09000032,Wandsworth,Middle East and Asia: Eastern Asia: Other Eastern Asia,436,271,165
E09000032,Wandsworth,Middle East and Asia: Middle East: Iran,159,201,-42
E09000032,Wandsworth,Middle East and Asia: Middle East: Iraq,102,31,71
E09000032,Wandsworth,Middle East and Asia: Middle East: Other Middle East,496,341,155
E09000032,Wandsworth,Middle East and Asia: South-East Asia: Malaysia,380,452,-72
E09000032,Wandsworth,Middle East and Asia: South-East Asia: Other South-East Asia,332,479,-147
E09000032,Wandsworth,Middle East and Asia: South-East Asia: Philippines,1165,1065,100
E09000032,Wandsworth,Middle East and Asia: South-East Asia: Singapore,199,129,70
E09000032,Wandsworth,Middle East and Asia: Southern Asia: Afghanistan,143,170,-27
E09000032,Wandsworth,Middle East and Asia: Southern Asia: Bangladesh,149,197,-48
E09000032,Wandsworth,Middle East and Asia: Southern Asia: India,1369,1538,-169
E09000032,Wandsworth,Middle East and Asia: Southern Asia: Other Southern Asia,74,112,-38
E09000032,Wandsworth,Middle East and Asia: Southern Asia: Pakistan,1385,1594,-209
E09000032,Wandsworth,Middle East and Asia: Southern Asia: Sri Lanka,205,330,-125
E09000032,Wandsworth,No passport held,13468,19040,-5572
E09000032,Wandsworth,The Americas and the Caribbean: Central America,250,191,59
E09000032,Wandsworth,The Americas and the Caribbean: North America: Canada,937,809,128
E09000032,Wandsworth,The Americas and the Caribbean: North America: United States,2606,2279,327
E09000032,Wandsworth,The Americas and the Caribbean: South America,2449,1985,464
E09000032,Wandsworth,The Americas and the Caribbean: The Caribbean: Jamaica,505,762,-257
E09000032,Wandsworth,The Americas and the Caribbean: The Caribbean: Other Caribbean,215,240,-25
E09000033,Westminster,Africa: Central and Western Africa: Ghana,80,140,-60
E09000033,Westminster,Africa: Central and Western Africa: Nigeria,368,536,-168
E09000033,Westminster,Africa: Central and Western Africa: Other Central and Western Africa,164,252,-88
E09000033,Westminster,Africa: North Africa,1129,1466,-337
E09000033,Westminster,Africa: South and Eastern Africa: Kenya,60,112,-52
E09000033,Westminster,Africa: South and Eastern Africa: Other South and Eastern Africa,213,359,-146
E09000033,Westminster,Africa: South and Eastern Africa: Somalia,5,23,-18
E09000033,Westminster,Africa: South and Eastern Africa: South Africa,333,519,-186
E09000033,Westminster,Africa: South and Eastern Africa: Zimbabwe,57,63,-6
E09000033,Westminster,Antarctica and Oceania: Australasia: Australia,1487,3538,-2051
E09000033,Westminster,Antarctica and Oceania: Australasia: New Zealand,352,1119,-767
E09000033,Westminster,Antarctica and Oceania: Other Antarctica and Oceania,46,24,22
E09000033,Westminster,British Overseas Territories,1,44,-43
E09000033,Westminster,Europe: Ireland,2829,3976,-1147
E09000033,Westminster,Europe: Other Europe: EU Member countries: France,6130,6848,-718
E09000033,Westminster,Europe: Other Europe: EU Member countries: Germany,2343,2872,-529
E09000033,Westminster,Europe: Other Europe: EU Member countries: Italy,6868,5188,1680
E09000033,Westminster,Europe: Other Europe: EU Member countries: Lithuania,527,387,140
E09000033,Westminster,Europe: Other Europe: EU Member countries: Other EU countries,10154,11836,-1682
E09000033,Westminster,Europe: Other Europe: EU Member countries: Poland,1553,1488,65
E09000033,Westminster,Europe: Other Europe: EU Member countries: Portugal,2728,2602,126
E09000033,Westminster,Europe: Other Europe: EU Member countries: Romania,1365,376,989
E09000033,Westminster,Europe: Other Europe: EU Member countries: Spain,4169,3497,672
E09000033,Westminster,Europe: Other Europe: Rest of Europe: Other Europe,3253,3251,2
E09000033,Westminster,Europe: Other Europe: Rest of Europe: Turkey,879,584,295
E09000033,Westminster,Europe: United Kingdom,129782,135535,-5753
E09000033,Westminster,Middle East and Asia: Central Asia,212,376,-164
E09000033,Westminster,Middle East and Asia: Eastern Asia: China,2190,1125,1065
E09000033,Westminster,Middle East and Asia: Eastern Asia: Hong Kong (Special Administrative Region of China),335,152,183
E09000033,Westminster,Middle East and Asia: Eastern Asia: Japan,1623,1825,-202
E09000033,Westminster,Middle East and Asia: Eastern Asia: Other Eastern Asia,528,631,-103
E09000033,Westminster,Middle East and Asia: Middle East: Iran,362,647,-285
E09000033,Westminster,Middle East and Asia: Middle East: Iraq,114,242,-128
E09000033,Westminster,Middle East and Asia: Middle East: Other Middle East,1405,2185,-780
E09000033,Westminster,Middle East and Asia: South-East Asia: Malaysia,873,1292,-419
E09000033,Westminster,Middle East and Asia: South-East Asia: Other South-East Asia,672,767,-95
E09000033,Westminster,Middle East and Asia: South-East Asia: Philippines,957,1103,-146
E09000033,Westminster,Middle East and Asia: South-East Asia: Singapore,440,486,-46
E09000033,Westminster,Middle East and Asia: Southern Asia: Afghanistan,40,78,-38
E09000033,Westminster,Middle East and Asia: Southern Asia: Bangladesh,400,434,-34
E09000033,Westminster,Middle East and Asia: Southern Asia: India,2253,2086,167
E09000033,Westminster,Middle East and Asia: Southern Asia: Other Southern Asia,94,80,14
E09000033,Westminster,Middle East and Asia: Southern Asia: Pakistan,392,464,-72
E09000033,Westminster,Middle East and Asia: Southern Asia: Sri Lanka,218,184,34
E09000033,Westminster,No passport held,5871,7905,-2034
E09000033,Westminster,The Americas and the Caribbean: Central America,301,305,-4
E09000033,Westminster,The Americas and the Caribbean: North America: Canada,1190,1536,-346
E09000033,Westminster,The Americas and the Caribbean: North America: United States,4795,6606,-1811
E09000033,Westminster,The Americas and the Caribbean: South America,1780,1867,-87
E09000033,Westminster,The Americas and the Caribbean: The Caribbean: Jamaica,71,148,-77
E09000033,Westminster,The Americas and the Caribbean: The Caribbean: Other Caribbean,250,237,13
